ID,Флаг дозвона,Флаг продажи,Расходы,PV,NPV
0,1,0,91,0,-91
1,1,0,65,0,-65
2,1,1,367,1449,1082
3,1,0,52,0,-52
4,1,1,357,1247,890
5,1,1,615,1536,921
6,1,1,1041,1466,425
7,1,0,52,0,-52
8,1,1,475,1942,1467
9,0,0,4,0,-4
10,0,0,61,0,-61
11,0,0,9,0,-9
12,1,1,898,1316,418
13,0,0,40,0,-40
14,0,0,4,0,-4
15,1,0,24,0,-24
16,1,0,78,0,-78
17,0,0,9,0,-9
18,0,0,9,0,-9
19,1,1,614,1388,774
20,1,1,204,1564,1360
21,0,0,85,0,-85
22,1,0,40,0,-40
23,1,0,0,0,0
24,1,1,554,1756,1202
25,1,0,168,0,-168
26,0,0,65,0,-65
27,0,0,28,0,-28
28,1,0,69,0,-69
29,0,0,23,0,-23
30,1,0,21,0,-21
31,1,1,157,1205,1048
32,1,0,9,0,-9
33,1,0,28,0,-28
34,1,0,36,0,-36
35,1,1,760,1259,499
36,0,0,5,0,-5
37,1,1,1069,1407,338
38,1,0,27,0,-27
39,0,0,43,0,-43
40,0,0,3,0,-3
41,0,0,52,0,-52
42,1,1,837,2482,1645
43,0,0,10,0,-10
44,0,0,54,0,-54
45,1,1,543,1349,806
46,1,0,25,0,-25
47,1,1,461,1301,840
48,1,0,97,0,-97
49,1,1,543,2032,1489
50,0,0,13,0,-13
51,1,1,236,1482,1246
52,1,0,143,0,-143
53,1,1,668,1498,830
54,1,1,52,1323,1271
55,0,0,0,0,0
56,1,1,450,3805,3355
57,0,0,8,0,-8
58,1,0,42,0,-42
59,1,1,2247,1839,-408
60,1,0,109,0,-109
61,1,1,554,1200,646
62,0,0,8,0,-8
63,0,0,23,0,-23
64,1,1,343,1534,1191
65,0,0,3,0,-3
66,0,0,77,0,-77
67,0,0,5,0,-5
68,1,1,406,1874,1468
69,1,1,1305,1274,-31
70,1,0,4,0,-4
71,1,0,17,0,-17
72,0,0,39,0,-39
73,1,0,180,0,-180
74,0,0,12,0,-12
75,1,0,237,0,-237
76,0,0,67,0,-67
77,0,0,15,0,-15
78,0,0,3,0,-3
79,0,0,92,0,-92
80,1,0,187,0,-187
81,0,0,8,0,-8
82,0,0,37,0,-37
83,1,1,721,1284,563
84,0,0,25,0,-25
85,0,0,99,0,-99
86,0,0,25,0,-25
87,1,0,23,0,-23
88,1,0,8,0,-8
89,1,0,3,0,-3
90,1,0,28,0,-28
91,1,0,7,0,-7
92,1,0,11,0,-11
93,1,0,35,0,-35
94,1,1,45,2237,2192
95,1,0,0,0,0
96,0,0,34,0,-34
97,0,0,19,0,-19
98,0,0,39,0,-39
99,0,0,74,0,-74
100,1,1,1902,1688,-214
101,1,0,19,0,-19
102,1,1,1105,1285,180
103,0,0,22,0,-22
104,0,0,83,0,-83
105,1,1,423,1348,925
106,1,0,1,0,-1
107,1,1,46,1266,1220
108,1,0,19,0,-19
109,1,1,281,1205,924
110,0,0,12,0,-12
111,0,0,99,0,-99
112,1,0,74,0,-74
113,0,0,1,0,-1
114,0,0,12,0,-12
115,1,0,159,0,-159
116,1,1,64,1770,1706
117,1,0,16,0,-16
118,1,0,65,0,-65
119,0,0,15,0,-15
120,0,0,172,0,-172
121,0,0,4,0,-4
122,1,0,48,0,-48
123,0,0,45,0,-45
124,1,1,463,1285,822
125,0,0,12,0,-12
126,1,1,58,1539,1481
127,1,0,140,0,-140
128,1,0,1,0,-1
129,1,1,313,1316,1003
130,1,0,14,0,-14
131,1,1,845,1378,533
132,1,1,165,1249,1084
133,0,0,84,0,-84
134,1,0,23,0,-23
135,1,1,202,1257,1055
136,0,0,0,0,0
137,1,1,143,1849,1706
138,1,1,547,1222,675
139,1,0,136,0,-136
140,0,0,5,0,-5
141,1,0,10,0,-10
142,1,1,74,1845,1771
143,0,0,59,0,-59
144,1,1,85,1218,1133
145,0,0,8,0,-8
146,0,0,144,0,-144
147,1,0,245,0,-245
148,0,0,5,0,-5
149,1,1,443,1363,920
150,1,0,23,0,-23
151,0,0,13,0,-13
152,0,0,39,0,-39
153,0,0,67,0,-67
154,0,0,44,0,-44
155,0,0,27,0,-27
156,0,0,95,0,-95
157,1,0,89,0,-89
158,0,0,94,0,-94
159,1,0,90,0,-90
160,0,0,62,0,-62
161,1,0,21,0,-21
162,0,0,18,0,-18
163,0,0,6,0,-6
164,1,0,73,0,-73
165,1,0,103,0,-103
166,1,1,589,1227,638
167,1,0,20,0,-20
168,0,0,22,0,-22
169,1,0,46,0,-46
170,0,0,147,0,-147
171,1,0,20,0,-20
172,0,0,184,0,-184
173,1,0,7,0,-7
174,1,0,0,0,0
175,1,1,111,1381,1270
176,1,0,83,0,-83
177,1,0,20,0,-20
178,0,0,8,0,-8
179,0,0,58,0,-58
180,1,0,60,0,-60
181,1,1,1169,2077,908
182,1,1,75,1477,1402
183,0,0,113,0,-113
184,1,1,494,1274,780
185,1,1,140,1507,1367
186,1,1,215,1320,1105
187,1,0,105,0,-105
188,1,0,46,0,-46
189,1,0,45,0,-45
190,1,1,430,1481,1051
191,1,1,134,1278,1144
192,1,0,39,0,-39
193,1,1,121,1342,1221
194,1,1,112,1243,1131
195,1,1,172,1523,1351
196,0,0,191,0,-191
197,1,0,77,0,-77
198,1,1,643,3017,2374
199,1,0,36,0,-36
200,1,0,26,0,-26
201,0,0,10,0,-10
202,1,0,52,0,-52
203,0,0,63,0,-63
204,0,0,9,0,-9
205,0,0,4,0,-4
206,0,0,38,0,-38
207,1,0,19,0,-19
208,0,0,43,0,-43
209,1,0,168,0,-168
210,1,0,2,0,-2
211,1,0,42,0,-42
212,0,0,49,0,-49
213,1,1,138,1767,1629
214,0,0,60,0,-60
215,1,1,1028,1579,551
216,1,1,242,1466,1224
217,1,1,367,1271,904
218,0,0,73,0,-73
219,0,0,99,0,-99
220,0,0,66,0,-66
221,0,0,1,0,-1
222,0,0,23,0,-23
223,0,0,1,0,-1
224,1,0,69,0,-69
225,0,0,38,0,-38
226,1,0,10,0,-10
227,1,0,40,0,-40
228,0,0,12,0,-12
229,1,0,68,0,-68
230,0,0,4,0,-4
231,0,0,53,0,-53
232,1,1,383,1773,1390
233,0,0,12,0,-12
234,0,0,78,0,-78
235,0,0,71,0,-71
236,1,1,892,1368,476
237,1,0,134,0,-134
238,1,0,55,0,-55
239,1,1,116,2180,2064
240,1,0,63,0,-63
241,0,0,41,0,-41
242,0,0,120,0,-120
243,0,0,3,0,-3
244,1,0,8,0,-8
245,1,0,58,0,-58
246,0,0,78,0,-78
247,1,1,547,2702,2155
248,1,1,712,1408,696
249,0,0,131,0,-131
250,1,1,658,1405,747
251,1,1,415,1700,1285
252,1,0,10,0,-10
253,0,0,19,0,-19
254,1,1,138,1722,1584
255,1,0,36,0,-36
256,0,0,100,0,-100
257,1,0,122,0,-122
258,1,1,175,1372,1197
259,0,0,64,0,-64
260,1,1,450,1779,1329
261,1,1,54,1435,1381
262,0,0,138,0,-138
263,1,0,6,0,-6
264,1,1,503,1777,1274
265,1,1,718,1548,830
266,1,1,1618,1723,105
267,1,1,1396,1512,116
268,0,0,5,0,-5
269,0,0,12,0,-12
270,0,0,21,0,-21
271,1,1,655,2108,1453
272,1,0,17,0,-17
273,0,0,64,0,-64
274,1,0,9,0,-9
275,0,0,4,0,-4
276,1,1,123,1308,1185
277,1,0,13,0,-13
278,0,0,0,0,0
279,1,0,103,0,-103
280,1,0,66,0,-66
281,1,1,110,1309,1199
282,1,1,2019,1845,-174
283,0,0,46,0,-46
284,0,0,23,0,-23
285,0,0,8,0,-8
286,0,0,83,0,-83
287,1,0,64,0,-64
288,0,0,33,0,-33
289,0,0,1,0,-1
290,1,0,30,0,-30
291,0,0,16,0,-16
292,1,1,671,1407,736
293,0,0,48,0,-48
294,1,0,2,0,-2
295,1,1,779,1410,631
296,1,0,206,0,-206
297,0,0,24,0,-24
298,0,0,77,0,-77
299,0,0,23,0,-23
300,0,0,52,0,-52
301,0,0,9,0,-9
302,0,0,96,0,-96
303,0,0,75,0,-75
304,0,0,15,0,-15
305,1,0,53,0,-53
306,1,0,92,0,-92
307,1,0,244,0,-244
308,1,1,166,1204,1038
309,1,0,96,0,-96
310,1,0,155,0,-155
311,1,1,1203,1209,6
312,1,1,478,1219,741
313,0,0,11,0,-11
314,0,0,29,0,-29
315,1,0,45,0,-45
316,0,0,31,0,-31
317,1,1,795,1424,629
318,1,0,57,0,-57
319,0,0,0,0,0
320,1,0,4,0,-4
321,0,0,41,0,-41
322,1,1,44,3319,3275
323,1,0,63,0,-63
324,0,0,200,0,-200
325,1,1,667,1278,611
326,0,0,31,0,-31
327,0,0,22,0,-22
328,1,1,288,1229,941
329,1,1,76,1284,1208
330,1,0,47,0,-47
331,0,0,79,0,-79
332,1,0,131,0,-131
333,0,0,41,0,-41
334,1,1,1464,1335,-129
335,0,0,31,0,-31
336,1,0,29,0,-29
337,0,0,26,0,-26
338,1,1,1373,2415,1042
339,0,0,168,0,-168
340,1,0,4,0,-4
341,1,0,12,0,-12
342,0,0,41,0,-41
343,0,0,16,0,-16
344,0,0,48,0,-48
345,1,1,344,1726,1382
346,0,0,63,0,-63
347,1,0,11,0,-11
348,1,0,36,0,-36
349,1,0,0,0,0
350,1,0,22,0,-22
351,0,0,29,0,-29
352,1,1,891,1308,417
353,1,0,67,0,-67
354,1,1,535,1941,1406
355,1,0,74,0,-74
356,1,1,530,1341,811
357,0,0,135,0,-135
358,1,1,2272,1331,-941
359,0,0,34,0,-34
360,1,0,1,0,-1
361,1,1,354,1216,862
362,1,0,10,0,-10
363,1,0,45,0,-45
364,0,0,77,0,-77
365,1,1,1327,1307,-20
366,1,0,84,0,-84
367,0,0,62,0,-62
368,1,0,48,0,-48
369,0,0,46,0,-46
370,1,1,235,1257,1022
371,1,0,134,0,-134
372,1,0,95,0,-95
373,0,0,94,0,-94
374,1,1,313,1693,1380
375,0,0,22,0,-22
376,0,0,167,0,-167
377,1,1,57,1693,1636
378,0,0,24,0,-24
379,0,0,4,0,-4
380,1,1,284,1346,1062
381,1,0,114,0,-114
382,0,0,58,0,-58
383,1,0,32,0,-32
384,0,0,7,0,-7
385,1,1,337,1883,1546
386,1,1,923,1694,771
387,1,0,228,0,-228
388,1,1,528,1221,693
389,0,0,25,0,-25
390,1,0,50,0,-50
391,0,0,33,0,-33
392,1,0,42,0,-42
393,1,1,724,1442,718
394,1,0,55,0,-55
395,0,0,75,0,-75
396,1,0,42,0,-42
397,0,0,4,0,-4
398,1,0,20,0,-20
399,0,0,34,0,-34
400,1,0,6,0,-6
401,0,0,117,0,-117
402,0,0,37,0,-37
403,0,0,49,0,-49
404,1,1,1511,1226,-285
405,1,0,16,0,-16
406,1,0,31,0,-31
407,1,1,555,1554,999
408,0,0,86,0,-86
409,0,0,129,0,-129
410,0,0,88,0,-88
411,1,1,666,1536,870
412,1,1,655,4353,3698
413,1,0,29,0,-29
414,1,0,22,0,-22
415,1,1,95,1793,1698
416,0,0,53,0,-53
417,1,0,17,0,-17
418,1,0,163,0,-163
419,1,0,41,0,-41
420,0,0,37,0,-37
421,1,1,709,1272,563
422,0,0,50,0,-50
423,1,1,1777,1432,-345
424,1,0,103,0,-103
425,1,0,49,0,-49
426,1,1,30,1391,1361
427,0,0,28,0,-28
428,1,0,50,0,-50
429,0,0,16,0,-16
430,0,0,23,0,-23
431,0,0,48,0,-48
432,0,0,120,0,-120
433,1,0,31,0,-31
434,1,0,49,0,-49
435,0,0,38,0,-38
436,0,0,15,0,-15
437,1,1,52,1230,1178
438,0,0,1,0,-1
439,1,0,13,0,-13
440,0,0,72,0,-72
441,1,0,37,0,-37
442,0,0,35,0,-35
443,1,1,988,1977,989
444,0,0,80,0,-80
445,0,0,4,0,-4
446,1,0,153,0,-153
447,0,0,66,0,-66
448,1,0,49,0,-49
449,0,0,67,0,-67
450,0,0,17,0,-17
451,0,0,13,0,-13
452,1,0,49,0,-49
453,1,1,1014,1329,315
454,1,0,44,0,-44
455,1,1,385,1204,819
456,1,1,1869,1781,-88
457,0,0,44,0,-44
458,1,1,1170,1216,46
459,1,1,382,1304,922
460,0,0,17,0,-17
461,1,1,76,1208,1132
462,1,1,2512,1279,-1233
463,1,0,26,0,-26
464,1,0,130,0,-130
465,1,0,26,0,-26
466,0,0,86,0,-86
467,0,0,259,0,-259
468,0,0,8,0,-8
469,1,0,35,0,-35
470,0,0,35,0,-35
471,1,0,39,0,-39
472,1,0,33,0,-33
473,0,0,32,0,-32
474,0,0,8,0,-8
475,1,1,506,1287,781
476,1,1,102,1397,1295
477,1,1,275,2812,2537
478,1,0,47,0,-47
479,1,0,26,0,-26
480,1,1,358,1220,862
481,0,0,8,0,-8
482,1,1,238,1308,1070
483,0,0,86,0,-86
484,1,0,17,0,-17
485,1,1,1210,1895,685
486,1,0,66,0,-66
487,1,1,273,1271,998
488,0,0,67,0,-67
489,0,0,128,0,-128
490,1,1,726,1743,1017
491,0,0,109,0,-109
492,0,0,5,0,-5
493,0,0,81,0,-81
494,1,1,108,2092,1984
495,1,0,40,0,-40
496,1,0,10,0,-10
497,1,0,51,0,-51
498,1,1,515,2773,2258
499,1,1,726,1551,825
500,1,0,104,0,-104
501,1,1,628,1378,750
502,0,0,11,0,-11
503,1,1,1001,1516,515
504,1,0,24,0,-24
505,1,1,352,1427,1075
506,1,1,108,1431,1323
507,1,0,24,0,-24
508,0,0,100,0,-100
509,0,0,10,0,-10
510,0,0,117,0,-117
511,0,0,67,0,-67
512,0,0,9,0,-9
513,1,0,40,0,-40
514,0,0,27,0,-27
515,1,0,32,0,-32
516,1,0,71,0,-71
517,1,0,48,0,-48
518,1,0,40,0,-40
519,0,0,63,0,-63
520,0,0,6,0,-6
521,0,0,82,0,-82
522,0,0,10,0,-10
523,1,1,121,2188,2067
524,1,1,1889,1509,-380
525,1,0,20,0,-20
526,0,0,31,0,-31
527,1,0,8,0,-8
528,1,0,42,0,-42
529,0,0,77,0,-77
530,1,0,4,0,-4
531,1,1,1759,1291,-468
532,0,0,3,0,-3
533,0,0,47,0,-47
534,1,1,17,1277,1260
535,0,0,13,0,-13
536,0,0,0,0,0
537,0,0,90,0,-90
538,1,0,33,0,-33
539,1,0,13,0,-13
540,0,0,28,0,-28
541,1,1,140,1720,1580
542,1,0,12,0,-12
543,0,0,57,0,-57
544,1,0,38,0,-38
545,0,0,26,0,-26
546,0,0,93,0,-93
547,1,0,26,0,-26
548,0,0,91,0,-91
549,0,0,12,0,-12
550,0,0,56,0,-56
551,1,0,1,0,-1
552,1,0,55,0,-55
553,1,1,289,1872,1583
554,1,0,4,0,-4
555,1,1,899,1276,377
556,1,0,1,0,-1
557,1,1,102,1226,1124
558,1,1,29,1296,1267
559,0,0,63,0,-63
560,1,0,36,0,-36
561,1,1,246,1342,1096
562,1,0,140,0,-140
563,1,1,1471,1348,-123
564,0,0,1,0,-1
565,1,1,1106,1597,491
566,0,0,77,0,-77
567,1,0,51,0,-51
568,0,0,65,0,-65
569,1,1,563,1453,890
570,1,1,74,1259,1185
571,0,0,31,0,-31
572,1,1,651,1382,731
573,0,0,13,0,-13
574,0,0,35,0,-35
575,0,0,11,0,-11
576,1,0,32,0,-32
577,0,0,43,0,-43
578,1,1,105,1213,1108
579,0,0,23,0,-23
580,1,0,119,0,-119
581,0,0,0,0,0
582,0,0,7,0,-7
583,0,0,25,0,-25
584,0,0,1,0,-1
585,0,0,10,0,-10
586,1,0,128,0,-128
587,1,1,1192,1339,147
588,0,0,140,0,-140
589,0,0,100,0,-100
590,0,0,137,0,-137
591,1,0,24,0,-24
592,1,0,29,0,-29
593,1,1,856,1337,481
594,0,0,217,0,-217
595,0,0,102,0,-102
596,0,0,37,0,-37
597,1,0,11,0,-11
598,1,0,60,0,-60
599,1,1,97,1693,1596
600,0,0,143,0,-143
601,1,0,22,0,-22
602,1,0,156,0,-156
603,1,1,233,3183,2950
604,1,0,119,0,-119
605,0,0,225,0,-225
606,0,0,136,0,-136
607,1,0,43,0,-43
608,0,0,22,0,-22
609,1,1,286,1407,1121
610,1,1,385,1906,1521
611,1,1,44,1685,1641
612,0,0,14,0,-14
613,1,1,418,1458,1040
614,1,1,232,1212,980
615,0,0,244,0,-244
616,1,0,17,0,-17
617,1,0,17,0,-17
618,1,0,29,0,-29
619,1,0,205,0,-205
620,0,0,50,0,-50
621,1,0,1,0,-1
622,1,0,63,0,-63
623,1,0,52,0,-52
624,0,0,45,0,-45
625,1,0,39,0,-39
626,1,0,25,0,-25
627,0,0,2,0,-2
628,1,1,656,1963,1307
629,1,0,20,0,-20
630,0,0,59,0,-59
631,1,0,14,0,-14
632,1,1,337,1589,1252
633,1,0,15,0,-15
634,1,1,346,1452,1106
635,1,1,682,1234,552
636,0,0,33,0,-33
637,1,1,759,1389,630
638,1,1,136,1327,1191
639,0,0,39,0,-39
640,0,0,55,0,-55
641,1,0,1,0,-1
642,0,0,53,0,-53
643,1,0,76,0,-76
644,0,0,35,0,-35
645,0,0,18,0,-18
646,1,0,21,0,-21
647,0,0,91,0,-91
648,0,0,42,0,-42
649,0,0,10,0,-10
650,1,0,56,0,-56
651,0,0,6,0,-6
652,0,0,47,0,-47
653,1,0,12,0,-12
654,1,0,29,0,-29
655,1,1,287,1211,924
656,0,0,24,0,-24
657,0,0,13,0,-13
658,0,0,76,0,-76
659,0,0,33,0,-33
660,1,1,176,2346,2170
661,1,0,61,0,-61
662,0,0,18,0,-18
663,1,1,208,1623,1415
664,1,0,45,0,-45
665,1,0,6,0,-6
666,0,0,60,0,-60
667,1,0,13,0,-13
668,1,0,75,0,-75
669,0,0,32,0,-32
670,0,0,0,0,0
671,1,0,6,0,-6
672,0,0,63,0,-63
673,1,0,70,0,-70
674,0,0,136,0,-136
675,1,1,236,1885,1649
676,1,0,58,0,-58
677,0,0,8,0,-8
678,1,1,1315,1356,41
679,1,1,359,1316,957
680,1,0,75,0,-75
681,0,0,31,0,-31
682,0,0,59,0,-59
683,0,0,24,0,-24
684,1,0,50,0,-50
685,1,0,39,0,-39
686,1,1,889,1382,493
687,1,0,19,0,-19
688,1,0,16,0,-16
689,1,0,80,0,-80
690,1,1,472,1853,1381
691,1,1,493,1203,710
692,1,1,124,1322,1198
693,0,0,32,0,-32
694,1,0,6,0,-6
695,1,0,5,0,-5
696,0,0,12,0,-12
697,1,0,36,0,-36
698,1,0,66,0,-66
699,1,1,91,1531,1440
700,0,0,15,0,-15
701,1,0,4,0,-4
702,1,0,6,0,-6
703,1,0,37,0,-37
704,0,0,221,0,-221
705,0,0,97,0,-97
706,0,0,31,0,-31
707,1,0,39,0,-39
708,0,0,14,0,-14
709,0,0,80,0,-80
710,0,0,105,0,-105
711,1,0,49,0,-49
712,0,0,32,0,-32
713,1,0,4,0,-4
714,0,0,74,0,-74
715,1,1,572,1348,776
716,0,0,12,0,-12
717,1,0,118,0,-118
718,1,0,77,0,-77
719,1,1,147,1272,1125
720,0,0,0,0,0
721,1,0,19,0,-19
722,1,0,63,0,-63
723,1,1,368,1360,992
724,1,1,84,1628,1544
725,1,1,238,1222,984
726,1,0,122,0,-122
727,0,0,16,0,-16
728,1,0,32,0,-32
729,0,0,88,0,-88
730,1,1,38,1507,1469
731,1,0,10,0,-10
732,1,1,744,1367,623
733,1,1,112,1241,1129
734,1,0,25,0,-25
735,0,0,62,0,-62
736,1,0,26,0,-26
737,1,0,48,0,-48
738,1,1,548,1980,1432
739,1,0,61,0,-61
740,0,0,5,0,-5
741,1,0,7,0,-7
742,1,1,379,1243,864
743,0,0,91,0,-91
744,1,1,562,1257,695
745,1,0,54,0,-54
746,1,1,382,1704,1322
747,1,1,536,1377,841
748,1,1,124,1282,1158
749,0,0,62,0,-62
750,1,0,21,0,-21
751,0,0,10,0,-10
752,1,0,28,0,-28
753,1,0,82,0,-82
754,1,1,380,1222,842
755,0,0,9,0,-9
756,1,0,23,0,-23
757,0,0,31,0,-31
758,1,1,820,1290,470
759,1,1,660,1471,811
760,1,1,809,1289,480
761,0,0,49,0,-49
762,1,1,118,1232,1114
763,1,0,15,0,-15
764,1,1,718,1443,725
765,1,0,85,0,-85
766,1,0,148,0,-148
767,1,1,1595,1543,-52
768,1,1,959,1485,526
769,1,0,8,0,-8
770,1,1,269,1617,1348
771,1,0,15,0,-15
772,1,0,95,0,-95
773,1,0,0,0,0
774,0,0,61,0,-61
775,1,1,1160,1273,113
776,1,0,22,0,-22
777,0,0,21,0,-21
778,0,0,131,0,-131
779,0,0,0,0,0
780,1,0,10,0,-10
781,1,1,269,1259,990
782,1,1,1020,1477,457
783,1,0,68,0,-68
784,1,1,974,1398,424
785,1,0,63,0,-63
786,1,1,101,1240,1139
787,0,0,14,0,-14
788,1,0,2,0,-2
789,1,1,1101,1444,343
790,0,0,101,0,-101
791,1,1,44,1281,1237
792,1,1,304,1271,967
793,0,0,97,0,-97
794,0,0,70,0,-70
795,1,0,61,0,-61
796,1,1,482,1206,724
797,1,0,89,0,-89
798,1,0,25,0,-25
799,1,0,8,0,-8
800,0,0,32,0,-32
801,0,0,189,0,-189
802,1,0,40,0,-40
803,1,1,1819,1203,-616
804,0,0,2,0,-2
805,0,0,5,0,-5
806,1,0,21,0,-21
807,1,1,1436,1235,-201
808,1,1,329,1523,1194
809,0,0,18,0,-18
810,1,1,106,1382,1276
811,1,1,314,1588,1274
812,0,0,77,0,-77
813,0,0,32,0,-32
814,1,1,477,1225,748
815,1,1,765,2178,1413
816,0,0,86,0,-86
817,1,1,62,1359,1297
818,1,0,139,0,-139
819,0,0,163,0,-163
820,0,0,2,0,-2
821,0,0,7,0,-7
822,0,0,7,0,-7
823,1,1,145,1326,1181
824,1,0,58,0,-58
825,1,0,22,0,-22
826,0,0,40,0,-40
827,0,0,7,0,-7
828,1,0,55,0,-55
829,0,0,20,0,-20
830,0,0,4,0,-4
831,1,1,38,1255,1217
832,1,1,269,1430,1161
833,0,0,16,0,-16
834,1,0,28,0,-28
835,0,0,30,0,-30
836,0,0,10,0,-10
837,0,0,33,0,-33
838,1,0,20,0,-20
839,0,0,21,0,-21
840,1,1,270,1225,955
841,0,0,10,0,-10
842,0,0,75,0,-75
843,1,1,152,3305,3153
844,1,0,54,0,-54
845,0,0,129,0,-129
846,0,0,50,0,-50
847,0,0,87,0,-87
848,1,0,10,0,-10
849,1,1,37,1546,1509
850,1,0,96,0,-96
851,1,0,7,0,-7
852,0,0,34,0,-34
853,1,1,463,2501,2038
854,1,1,1029,1208,179
855,1,0,219,0,-219
856,0,0,6,0,-6
857,1,0,64,0,-64
858,0,0,6,0,-6
859,0,0,4,0,-4
860,1,0,29,0,-29
861,1,1,444,1276,832
862,0,0,15,0,-15
863,1,1,537,1826,1289
864,0,0,3,0,-3
865,1,1,352,2247,1895
866,1,0,57,0,-57
867,1,1,639,1549,910
868,0,0,135,0,-135
869,1,1,34,1361,1327
870,0,0,1,0,-1
871,1,0,24,0,-24
872,1,1,297,1473,1176
873,0,0,10,0,-10
874,0,0,41,0,-41
875,1,1,636,1479,843
876,0,0,10,0,-10
877,0,0,81,0,-81
878,1,1,802,1434,632
879,1,0,27,0,-27
880,1,1,898,1211,313
881,0,0,11,0,-11
882,1,1,562,1200,638
883,1,1,218,1290,1072
884,1,1,515,1333,818
885,0,0,2,0,-2
886,0,0,17,0,-17
887,0,0,7,0,-7
888,0,0,48,0,-48
889,1,1,390,1535,1145
890,0,0,41,0,-41
891,1,0,7,0,-7
892,1,1,45,1592,1547
893,0,0,44,0,-44
894,1,0,7,0,-7
895,0,0,79,0,-79
896,1,0,62,0,-62
897,0,0,11,0,-11
898,0,0,58,0,-58
899,0,0,8,0,-8
900,1,1,610,1200,590
901,0,0,76,0,-76
902,1,1,693,1350,657
903,1,1,1331,2746,1415
904,1,1,2587,1426,-1161
905,1,0,16,0,-16
906,0,0,30,0,-30
907,1,0,68,0,-68
908,0,0,22,0,-22
909,1,1,69,1283,1214
910,1,0,88,0,-88
911,1,1,371,1318,947
912,1,1,151,1318,1167
913,0,0,8,0,-8
914,1,0,25,0,-25
915,1,0,90,0,-90
916,0,0,40,0,-40
917,0,0,15,0,-15
918,0,0,42,0,-42
919,0,0,53,0,-53
920,1,1,958,1316,358
921,1,1,78,1896,1818
922,0,0,103,0,-103
923,1,0,73,0,-73
924,1,0,5,0,-5
925,0,0,240,0,-240
926,1,1,31,1361,1330
927,1,0,99,0,-99
928,0,0,53,0,-53
929,1,1,155,1210,1055
930,1,0,14,0,-14
931,0,0,139,0,-139
932,1,1,391,1257,866
933,1,0,5,0,-5
934,0,0,87,0,-87
935,1,0,17,0,-17
936,1,1,283,2096,1813
937,1,1,442,1226,784
938,0,0,41,0,-41
939,1,1,110,1699,1589
940,0,0,11,0,-11
941,1,1,1210,1771,561
942,0,0,5,0,-5
943,0,0,186,0,-186
944,1,0,32,0,-32
945,0,0,52,0,-52
946,0,0,38,0,-38
947,1,0,5,0,-5
948,1,1,763,1512,749
949,1,1,85,1306,1221
950,0,0,55,0,-55
951,0,0,127,0,-127
952,0,0,10,0,-10
953,0,0,14,0,-14
954,1,1,476,1345,869
955,0,0,40,0,-40
956,1,0,56,0,-56
957,0,0,67,0,-67
958,0,0,103,0,-103
959,1,1,527,1221,694
960,1,1,970,1604,634
961,1,1,1086,1594,508
962,0,0,136,0,-136
963,0,0,16,0,-16
964,0,0,12,0,-12
965,0,0,41,0,-41
966,1,0,19,0,-19
967,0,0,46,0,-46
968,0,0,11,0,-11
969,0,0,47,0,-47
970,0,0,180,0,-180
971,0,0,45,0,-45
972,0,0,18,0,-18
973,1,0,150,0,-150
974,1,0,5,0,-5
975,1,0,16,0,-16
976,1,0,153,0,-153
977,1,1,223,1264,1041
978,1,1,617,1561,944
979,1,1,779,1284,505
980,1,1,275,1633,1358
981,1,0,124,0,-124
982,0,0,21,0,-21
983,1,1,192,2348,2156
984,1,0,34,0,-34
985,1,0,60,0,-60
986,0,0,48,0,-48
987,1,0,54,0,-54
988,0,0,24,0,-24
989,0,0,71,0,-71
990,0,0,1,0,-1
991,1,0,2,0,-2
992,0,0,32,0,-32
993,0,0,3,0,-3
994,1,1,96,1205,1109
995,1,0,31,0,-31
996,1,1,528,1202,674
997,1,0,8,0,-8
998,0,0,99,0,-99
999,1,1,152,1344,1192
1000,1,0,26,0,-26
1001,1,1,385,1283,898
1002,0,0,58,0,-58
1003,0,0,35,0,-35
1004,1,0,7,0,-7
1005,0,0,3,0,-3
1006,0,0,27,0,-27
1007,0,0,69,0,-69
1008,1,0,72,0,-72
1009,1,0,7,0,-7
1010,0,0,12,0,-12
1011,1,0,15,0,-15
1012,1,0,73,0,-73
1013,1,1,390,1745,1355
1014,0,0,73,0,-73
1015,0,0,71,0,-71
1016,1,1,478,1331,853
1017,1,1,118,1273,1155
1018,1,0,98,0,-98
1019,0,0,160,0,-160
1020,1,0,91,0,-91
1021,0,0,83,0,-83
1022,1,0,45,0,-45
1023,0,0,18,0,-18
1024,0,0,83,0,-83
1025,1,0,13,0,-13
1026,1,1,152,1385,1233
1027,0,0,50,0,-50
1028,0,0,12,0,-12
1029,1,0,113,0,-113
1030,0,0,119,0,-119
1031,1,1,889,1238,349
1032,1,1,175,1636,1461
1033,1,1,745,1374,629
1034,1,0,10,0,-10
1035,0,0,8,0,-8
1036,1,0,6,0,-6
1037,1,0,11,0,-11
1038,1,1,419,1520,1101
1039,1,1,32,1472,1440
1040,1,1,625,1204,579
1041,1,0,11,0,-11
1042,0,0,128,0,-128
1043,0,0,51,0,-51
1044,0,0,62,0,-62
1045,0,0,9,0,-9
1046,0,0,74,0,-74
1047,1,0,10,0,-10
1048,1,1,598,1716,1118
1049,1,1,1956,2255,299
1050,1,0,12,0,-12
1051,1,1,979,1953,974
1052,1,1,58,1333,1275
1053,1,1,135,1275,1140
1054,1,1,355,1690,1335
1055,0,0,173,0,-173
1056,1,1,1369,1549,180
1057,0,0,103,0,-103
1058,0,0,65,0,-65
1059,0,0,62,0,-62
1060,1,1,541,1285,744
1061,1,1,784,1603,819
1062,1,0,28,0,-28
1063,1,0,12,0,-12
1064,1,1,62,5567,5505
1065,1,1,154,1356,1202
1066,1,1,103,2295,2192
1067,0,0,1,0,-1
1068,1,0,42,0,-42
1069,0,0,3,0,-3
1070,0,0,68,0,-68
1071,0,0,4,0,-4
1072,1,0,51,0,-51
1073,1,0,25,0,-25
1074,1,0,7,0,-7
1075,0,0,44,0,-44
1076,0,0,71,0,-71
1077,1,1,886,1259,373
1078,0,0,42,0,-42
1079,1,0,2,0,-2
1080,1,0,23,0,-23
1081,0,0,59,0,-59
1082,1,1,200,1220,1020
1083,1,1,1969,1578,-391
1084,0,0,30,0,-30
1085,1,0,28,0,-28
1086,1,1,1238,2529,1291
1087,0,0,8,0,-8
1088,1,1,80,1418,1338
1089,1,0,50,0,-50
1090,0,0,127,0,-127
1091,0,0,217,0,-217
1092,1,0,55,0,-55
1093,0,0,20,0,-20
1094,1,0,373,0,-373
1095,0,0,60,0,-60
1096,1,0,2,0,-2
1097,1,0,59,0,-59
1098,0,0,93,0,-93
1099,0,0,26,0,-26
1100,0,0,63,0,-63
1101,1,0,4,0,-4
1102,1,0,107,0,-107
1103,1,1,302,1372,1070
1104,1,0,142,0,-142
1105,1,0,35,0,-35
1106,1,1,881,1598,717
1107,1,1,162,1282,1120
1108,1,1,1586,1359,-227
1109,1,1,2137,1212,-925
1110,1,0,144,0,-144
1111,1,1,1211,1438,227
1112,0,0,6,0,-6
1113,1,1,146,2648,2502
1114,1,0,73,0,-73
1115,0,0,14,0,-14
1116,1,1,888,1392,504
1117,1,1,1725,1991,266
1118,0,0,4,0,-4
1119,1,0,56,0,-56
1120,1,0,65,0,-65
1121,0,0,164,0,-164
1122,1,1,310,1420,1110
1123,0,0,31,0,-31
1124,0,0,33,0,-33
1125,1,1,1639,1597,-42
1126,0,0,27,0,-27
1127,1,1,562,2150,1588
1128,1,0,29,0,-29
1129,0,0,84,0,-84
1130,1,0,12,0,-12
1131,0,0,42,0,-42
1132,0,0,42,0,-42
1133,1,0,11,0,-11
1134,1,0,35,0,-35
1135,0,0,156,0,-156
1136,0,0,4,0,-4
1137,1,1,536,2038,1502
1138,1,1,101,2090,1989
1139,0,0,177,0,-177
1140,0,0,63,0,-63
1141,1,0,4,0,-4
1142,1,1,292,1511,1219
1143,1,0,1,0,-1
1144,0,0,137,0,-137
1145,1,0,13,0,-13
1146,1,0,24,0,-24
1147,1,0,12,0,-12
1148,1,0,68,0,-68
1149,1,1,465,2161,1696
1150,1,0,93,0,-93
1151,1,1,581,1497,916
1152,1,0,123,0,-123
1153,1,1,165,1288,1123
1154,1,0,1,0,-1
1155,1,0,12,0,-12
1156,1,0,36,0,-36
1157,1,1,599,1441,842
1158,0,0,11,0,-11
1159,1,1,119,1534,1415
1160,1,1,79,1837,1758
1161,1,0,26,0,-26
1162,1,1,961,1567,606
1163,1,0,100,0,-100
1164,0,0,83,0,-83
1165,0,0,67,0,-67
1166,1,0,31,0,-31
1167,1,1,1168,1387,219
1168,1,1,551,1346,795
1169,1,1,180,3481,3301
1170,1,0,21,0,-21
1171,1,0,83,0,-83
1172,1,1,730,1367,637
1173,1,0,58,0,-58
1174,1,0,10,0,-10
1175,1,1,129,1344,1215
1176,1,1,106,1867,1761
1177,0,0,33,0,-33
1178,1,0,8,0,-8
1179,0,0,76,0,-76
1180,0,0,33,0,-33
1181,0,0,20,0,-20
1182,1,1,906,1555,649
1183,1,1,126,1413,1287
1184,0,0,22,0,-22
1185,1,1,183,1461,1278
1186,1,0,53,0,-53
1187,1,0,32,0,-32
1188,1,0,84,0,-84
1189,0,0,24,0,-24
1190,1,1,766,4201,3435
1191,1,0,74,0,-74
1192,0,0,14,0,-14
1193,1,1,99,1381,1282
1194,1,0,63,0,-63
1195,0,0,61,0,-61
1196,1,1,836,1697,861
1197,1,1,339,1396,1057
1198,0,0,58,0,-58
1199,0,0,7,0,-7
1200,0,0,51,0,-51
1201,0,0,18,0,-18
1202,1,0,146,0,-146
1203,0,0,27,0,-27
1204,1,0,63,0,-63
1205,0,0,40,0,-40
1206,0,0,219,0,-219
1207,1,1,589,1633,1044
1208,0,0,3,0,-3
1209,0,0,72,0,-72
1210,1,1,695,1414,719
1211,1,1,296,1937,1641
1212,0,0,50,0,-50
1213,0,0,5,0,-5
1214,1,0,60,0,-60
1215,1,0,29,0,-29
1216,0,0,8,0,-8
1217,0,0,101,0,-101
1218,1,0,31,0,-31
1219,0,0,118,0,-118
1220,1,1,458,1342,884
1221,0,0,5,0,-5
1222,1,0,26,0,-26
1223,1,1,202,1316,1114
1224,1,0,75,0,-75
1225,0,0,66,0,-66
1226,0,0,16,0,-16
1227,1,1,734,1476,742
1228,1,0,166,0,-166
1229,0,0,94,0,-94
1230,1,1,260,1207,947
1231,1,1,313,2370,2057
1232,1,0,272,0,-272
1233,1,0,64,0,-64
1234,1,1,240,1640,1400
1235,1,0,9,0,-9
1236,1,1,148,1503,1355
1237,1,0,23,0,-23
1238,1,1,59,1329,1270
1239,1,0,56,0,-56
1240,0,0,80,0,-80
1241,0,0,11,0,-11
1242,0,0,32,0,-32
1243,1,1,1368,1211,-157
1244,1,0,29,0,-29
1245,0,0,22,0,-22
1246,1,1,83,1469,1386
1247,0,0,27,0,-27
1248,0,0,50,0,-50
1249,1,0,9,0,-9
1250,1,1,414,2411,1997
1251,0,0,28,0,-28
1252,0,0,129,0,-129
1253,0,0,64,0,-64
1254,0,0,16,0,-16
1255,1,0,4,0,-4
1256,1,1,296,1454,1158
1257,1,0,51,0,-51
1258,1,0,28,0,-28
1259,1,0,99,0,-99
1260,0,0,5,0,-5
1261,1,0,34,0,-34
1262,0,0,32,0,-32
1263,0,0,6,0,-6
1264,1,1,393,1294,901
1265,1,1,1336,1218,-118
1266,0,0,163,0,-163
1267,0,0,5,0,-5
1268,1,1,410,1703,1293
1269,1,0,96,0,-96
1270,0,0,62,0,-62
1271,1,1,1237,1331,94
1272,0,0,0,0,0
1273,0,0,33,0,-33
1274,0,0,4,0,-4
1275,0,0,58,0,-58
1276,0,0,111,0,-111
1277,1,0,38,0,-38
1278,1,1,821,1387,566
1279,1,1,884,1557,673
1280,1,1,739,1349,610
1281,0,0,18,0,-18
1282,1,0,100,0,-100
1283,1,1,68,1328,1260
1284,1,0,209,0,-209
1285,0,0,5,0,-5
1286,1,0,56,0,-56
1287,1,1,616,1292,676
1288,0,0,128,0,-128
1289,1,0,56,0,-56
1290,1,1,398,1688,1290
1291,0,0,39,0,-39
1292,0,0,135,0,-135
1293,0,0,53,0,-53
1294,0,0,39,0,-39
1295,1,0,65,0,-65
1296,1,0,26,0,-26
1297,0,0,83,0,-83
1298,1,0,17,0,-17
1299,0,0,39,0,-39
1300,0,0,38,0,-38
1301,1,0,1,0,-1
1302,1,0,119,0,-119
1303,1,1,333,1530,1197
1304,0,0,119,0,-119
1305,0,0,33,0,-33
1306,0,0,89,0,-89
1307,0,0,103,0,-103
1308,1,0,74,0,-74
1309,1,0,41,0,-41
1310,1,1,681,1281,600
1311,0,0,20,0,-20
1312,1,1,184,1350,1166
1313,0,0,69,0,-69
1314,1,0,40,0,-40
1315,1,0,48,0,-48
1316,0,0,13,0,-13
1317,1,0,28,0,-28
1318,1,0,81,0,-81
1319,1,0,2,0,-2
1320,1,1,472,2175,1703
1321,1,1,1407,1711,304
1322,0,0,60,0,-60
1323,1,1,337,1381,1044
1324,0,0,2,0,-2
1325,1,1,939,1328,389
1326,1,0,59,0,-59
1327,1,1,264,1271,1007
1328,0,0,40,0,-40
1329,0,0,1,0,-1
1330,0,0,18,0,-18
1331,1,0,6,0,-6
1332,1,0,34,0,-34
1333,0,0,18,0,-18
1334,1,0,44,0,-44
1335,0,0,1,0,-1
1336,1,0,145,0,-145
1337,1,0,39,0,-39
1338,1,1,287,1397,1110
1339,1,0,14,0,-14
1340,0,0,63,0,-63
1341,1,0,37,0,-37
1342,1,0,28,0,-28
1343,1,1,523,1394,871
1344,1,0,13,0,-13
1345,0,0,78,0,-78
1346,0,0,60,0,-60
1347,0,0,44,0,-44
1348,1,1,142,1294,1152
1349,1,0,29,0,-29
1350,1,0,9,0,-9
1351,1,1,180,1425,1245
1352,1,1,945,1447,502
1353,1,1,265,2089,1824
1354,0,0,22,0,-22
1355,1,1,909,1366,457
1356,0,0,10,0,-10
1357,1,0,228,0,-228
1358,1,0,46,0,-46
1359,1,1,458,2046,1588
1360,0,0,43,0,-43
1361,1,1,54,1385,1331
1362,0,0,91,0,-91
1363,1,0,44,0,-44
1364,0,0,10,0,-10
1365,0,0,159,0,-159
1366,1,0,34,0,-34
1367,1,0,0,0,0
1368,1,1,81,1828,1747
1369,0,0,24,0,-24
1370,1,0,165,0,-165
1371,0,0,1,0,-1
1372,0,0,35,0,-35
1373,1,1,878,1293,415
1374,1,1,204,1234,1030
1375,1,0,159,0,-159
1376,1,0,76,0,-76
1377,0,0,156,0,-156
1378,1,1,504,1494,990
1379,1,0,232,0,-232
1380,1,0,40,0,-40
1381,0,0,59,0,-59
1382,1,0,106,0,-106
1383,1,1,349,1916,1567
1384,0,0,5,0,-5
1385,0,0,12,0,-12
1386,1,1,461,2366,1905
1387,0,0,52,0,-52
1388,1,0,73,0,-73
1389,0,0,6,0,-6
1390,1,1,90,1261,1171
1391,0,0,16,0,-16
1392,1,0,3,0,-3
1393,1,0,8,0,-8
1394,1,1,286,1473,1187
1395,0,0,18,0,-18
1396,0,0,44,0,-44
1397,1,0,78,0,-78
1398,1,1,380,1218,838
1399,0,0,19,0,-19
1400,1,1,373,1328,955
1401,1,1,692,1407,715
1402,1,1,305,2763,2458
1403,1,1,85,1625,1540
1404,1,1,249,1450,1201
1405,1,1,881,1870,989
1406,0,0,312,0,-312
1407,1,0,43,0,-43
1408,0,0,373,0,-373
1409,1,0,259,0,-259
1410,1,1,121,1285,1164
1411,1,0,157,0,-157
1412,1,0,4,0,-4
1413,0,0,40,0,-40
1414,1,1,183,1592,1409
1415,1,1,657,1729,1072
1416,1,0,71,0,-71
1417,0,0,89,0,-89
1418,1,0,3,0,-3
1419,0,0,82,0,-82
1420,0,0,84,0,-84
1421,1,0,42,0,-42
1422,0,0,4,0,-4
1423,1,1,109,1402,1293
1424,1,0,28,0,-28
1425,0,0,13,0,-13
1426,1,1,1161,2421,1260
1427,1,0,17,0,-17
1428,1,1,151,1420,1269
1429,0,0,8,0,-8
1430,1,0,50,0,-50
1431,0,0,58,0,-58
1432,0,0,77,0,-77
1433,1,1,102,2246,2144
1434,1,1,1092,2041,949
1435,1,1,309,1217,908
1436,1,0,65,0,-65
1437,1,1,1347,1391,44
1438,1,0,144,0,-144
1439,1,0,13,0,-13
1440,1,1,942,1504,562
1441,0,0,0,0,0
1442,1,1,1236,1434,198
1443,1,0,2,0,-2
1444,0,0,22,0,-22
1445,0,0,93,0,-93
1446,0,0,6,0,-6
1447,1,1,1015,1391,376
1448,1,0,96,0,-96
1449,0,0,63,0,-63
1450,1,1,416,1225,809
1451,1,1,669,1274,605
1452,1,0,19,0,-19
1453,0,0,16,0,-16
1454,1,0,35,0,-35
1455,0,0,16,0,-16
1456,0,0,23,0,-23
1457,1,1,309,2689,2380
1458,1,0,2,0,-2
1459,0,0,52,0,-52
1460,1,0,20,0,-20
1461,0,0,45,0,-45
1462,0,0,89,0,-89
1463,1,0,131,0,-131
1464,1,1,240,2230,1990
1465,1,0,55,0,-55
1466,0,0,65,0,-65
1467,1,1,443,1388,945
1468,0,0,130,0,-130
1469,1,1,378,2004,1626
1470,1,0,77,0,-77
1471,0,0,135,0,-135
1472,1,1,157,1210,1053
1473,0,0,4,0,-4
1474,0,0,58,0,-58
1475,1,0,28,0,-28
1476,1,1,229,1240,1011
1477,1,0,28,0,-28
1478,0,0,64,0,-64
1479,0,0,18,0,-18
1480,1,1,338,1288,950
1481,0,0,28,0,-28
1482,1,1,458,2342,1884
1483,0,0,25,0,-25
1484,0,0,4,0,-4
1485,0,0,30,0,-30
1486,1,0,61,0,-61
1487,0,0,59,0,-59
1488,0,0,12,0,-12
1489,1,0,4,0,-4
1490,0,0,21,0,-21
1491,1,0,26,0,-26
1492,0,0,82,0,-82
1493,0,0,245,0,-245
1494,0,0,7,0,-7
1495,0,0,4,0,-4
1496,1,1,669,1335,666
1497,1,0,46,0,-46
1498,0,0,53,0,-53
1499,1,0,37,0,-37
1500,1,1,61,1322,1261
1501,1,1,161,1203,1042
1502,0,0,40,0,-40
1503,1,1,580,1326,746
1504,0,0,42,0,-42
1505,1,1,412,1298,886
1506,1,1,264,2544,2280
1507,0,0,92,0,-92
1508,1,1,122,1241,1119
1509,0,0,3,0,-3
1510,1,0,42,0,-42
1511,1,0,30,0,-30
1512,1,0,112,0,-112
1513,1,0,105,0,-105
1514,1,1,1587,1664,77
1515,1,1,420,1244,824
1516,1,1,14,1426,1412
1517,1,1,398,1283,885
1518,1,0,13,0,-13
1519,0,0,185,0,-185
1520,0,0,40,0,-40
1521,1,0,66,0,-66
1522,0,0,93,0,-93
1523,1,1,560,1395,835
1524,0,0,39,0,-39
1525,1,0,19,0,-19
1526,1,1,388,2109,1721
1527,1,1,105,1519,1414
1528,0,0,7,0,-7
1529,1,1,448,1878,1430
1530,1,1,1072,1295,223
1531,0,0,35,0,-35
1532,0,0,63,0,-63
1533,0,0,17,0,-17
1534,0,0,127,0,-127
1535,0,0,1,0,-1
1536,1,0,17,0,-17
1537,0,0,25,0,-25
1538,1,1,442,1312,870
1539,1,0,26,0,-26
1540,1,0,0,0,0
1541,1,1,33,1216,1183
1542,1,0,17,0,-17
1543,0,0,86,0,-86
1544,1,0,0,0,0
1545,1,0,7,0,-7
1546,1,0,45,0,-45
1547,1,0,11,0,-11
1548,0,0,32,0,-32
1549,0,0,70,0,-70
1550,1,1,673,1561,888
1551,0,0,108,0,-108
1552,0,0,74,0,-74
1553,1,1,1750,1261,-489
1554,1,0,125,0,-125
1555,1,1,1619,1208,-411
1556,1,0,2,0,-2
1557,1,0,16,0,-16
1558,1,0,58,0,-58
1559,0,0,20,0,-20
1560,1,1,644,1430,786
1561,1,1,62,1741,1679
1562,1,0,149,0,-149
1563,1,1,607,1449,842
1564,0,0,148,0,-148
1565,1,1,1302,1356,54
1566,1,0,28,0,-28
1567,1,1,624,1541,917
1568,1,0,30,0,-30
1569,0,0,43,0,-43
1570,1,1,1288,2547,1259
1571,0,0,77,0,-77
1572,0,0,24,0,-24
1573,0,0,33,0,-33
1574,1,0,7,0,-7
1575,1,0,47,0,-47
1576,0,0,61,0,-61
1577,1,0,244,0,-244
1578,1,1,513,1543,1030
1579,1,0,58,0,-58
1580,1,1,602,1309,707
1581,1,0,4,0,-4
1582,1,1,115,1208,1093
1583,1,0,33,0,-33
1584,0,0,15,0,-15
1585,1,0,70,0,-70
1586,0,0,30,0,-30
1587,0,0,61,0,-61
1588,0,0,123,0,-123
1589,0,0,12,0,-12
1590,1,1,418,1214,796
1591,0,0,63,0,-63
1592,0,0,37,0,-37
1593,0,0,57,0,-57
1594,0,0,78,0,-78
1595,1,1,355,1561,1206
1596,1,1,831,1506,675
1597,1,0,53,0,-53
1598,1,0,24,0,-24
1599,0,0,33,0,-33
1600,1,1,1198,1272,74
1601,1,0,148,0,-148
1602,0,0,20,0,-20
1603,1,1,975,1372,397
1604,1,0,8,0,-8
1605,0,0,35,0,-35
1606,1,0,64,0,-64
1607,1,0,0,0,0
1608,0,0,264,0,-264
1609,0,0,11,0,-11
1610,1,1,175,1498,1323
1611,1,0,83,0,-83
1612,0,0,22,0,-22
1613,0,0,145,0,-145
1614,1,0,3,0,-3
1615,1,0,85,0,-85
1616,1,1,78,1493,1415
1617,1,1,125,2232,2107
1618,1,1,729,1290,561
1619,0,0,8,0,-8
1620,0,0,82,0,-82
1621,0,0,18,0,-18
1622,1,1,653,1914,1261
1623,1,0,45,0,-45
1624,1,1,1032,1631,599
1625,1,1,33,1319,1286
1626,1,0,21,0,-21
1627,0,0,4,0,-4
1628,1,0,3,0,-3
1629,1,0,21,0,-21
1630,0,0,29,0,-29
1631,0,0,6,0,-6
1632,0,0,104,0,-104
1633,1,1,185,1285,1100
1634,0,0,25,0,-25
1635,1,1,110,1513,1403
1636,1,0,17,0,-17
1637,1,1,222,1478,1256
1638,1,1,35,1339,1304
1639,0,0,38,0,-38
1640,0,0,7,0,-7
1641,1,1,944,1215,271
1642,0,0,88,0,-88
1643,1,0,9,0,-9
1644,1,0,6,0,-6
1645,1,0,21,0,-21
1646,0,0,17,0,-17
1647,1,1,231,1270,1039
1648,1,1,201,1262,1061
1649,0,0,26,0,-26
1650,1,0,38,0,-38
1651,1,0,29,0,-29
1652,0,0,149,0,-149
1653,1,0,56,0,-56
1654,1,0,3,0,-3
1655,1,0,18,0,-18
1656,1,1,136,1261,1125
1657,0,0,14,0,-14
1658,0,0,16,0,-16
1659,1,0,3,0,-3
1660,1,0,114,0,-114
1661,1,0,118,0,-118
1662,1,0,1,0,-1
1663,1,1,233,1476,1243
1664,0,0,11,0,-11
1665,1,1,1144,2061,917
1666,1,1,271,1478,1207
1667,1,0,1,0,-1
1668,1,0,140,0,-140
1669,0,0,14,0,-14
1670,0,0,78,0,-78
1671,0,0,100,0,-100
1672,1,1,627,1560,933
1673,0,0,8,0,-8
1674,1,0,18,0,-18
1675,1,0,25,0,-25
1676,1,0,144,0,-144
1677,1,1,344,1219,875
1678,1,0,18,0,-18
1679,0,0,20,0,-20
1680,1,0,77,0,-77
1681,0,0,36,0,-36
1682,0,0,171,0,-171
1683,1,0,199,0,-199
1684,0,0,81,0,-81
1685,1,0,265,0,-265
1686,0,0,14,0,-14
1687,0,0,85,0,-85
1688,0,0,12,0,-12
1689,1,0,39,0,-39
1690,0,0,13,0,-13
1691,1,0,36,0,-36
1692,1,0,71,0,-71
1693,0,0,53,0,-53
1694,1,0,4,0,-4
1695,1,1,603,1786,1183
1696,1,1,334,1350,1016
1697,0,0,97,0,-97
1698,1,0,39,0,-39
1699,0,0,32,0,-32
1700,1,0,19,0,-19
1701,0,0,74,0,-74
1702,1,0,5,0,-5
1703,0,0,3,0,-3
1704,1,1,73,1699,1626
1705,1,0,23,0,-23
1706,0,0,6,0,-6
1707,1,1,299,1751,1452
1708,1,0,28,0,-28
1709,1,0,39,0,-39
1710,0,0,2,0,-2
1711,0,0,125,0,-125
1712,0,0,41,0,-41
1713,0,0,92,0,-92
1714,1,1,862,1453,591
1715,1,1,327,1242,915
1716,0,0,176,0,-176
1717,1,0,73,0,-73
1718,1,1,121,1671,1550
1719,1,0,39,0,-39
1720,1,1,1693,2281,588
1721,0,0,19,0,-19
1722,1,0,17,0,-17
1723,1,1,1687,1577,-110
1724,1,1,691,1289,598
1725,1,1,935,1218,283
1726,1,0,55,0,-55
1727,0,0,53,0,-53
1728,1,0,42,0,-42
1729,1,0,24,0,-24
1730,1,0,1,0,-1
1731,0,0,105,0,-105
1732,0,0,17,0,-17
1733,1,1,242,1385,1143
1734,1,1,117,2168,2051
1735,0,0,17,0,-17
1736,0,0,9,0,-9
1737,1,1,368,1206,838
1738,0,0,81,0,-81
1739,1,0,52,0,-52
1740,1,1,720,1501,781
1741,0,0,55,0,-55
1742,1,1,649,1884,1235
1743,1,0,1,0,-1
1744,1,1,713,1287,574
1745,1,1,31,1239,1208
1746,0,0,87,0,-87
1747,0,0,5,0,-5
1748,1,0,37,0,-37
1749,1,0,1,0,-1
1750,1,1,521,1512,991
1751,1,0,79,0,-79
1752,1,0,98,0,-98
1753,0,0,78,0,-78
1754,1,1,321,1418,1097
1755,1,1,104,1241,1137
1756,0,0,31,0,-31
1757,1,1,234,1691,1457
1758,0,0,93,0,-93
1759,1,1,297,1365,1068
1760,1,0,71,0,-71
1761,0,0,48,0,-48
1762,1,1,1230,2165,935
1763,0,0,17,0,-17
1764,1,0,70,0,-70
1765,1,0,130,0,-130
1766,0,0,10,0,-10
1767,0,0,19,0,-19
1768,1,1,87,1551,1464
1769,0,0,25,0,-25
1770,1,0,32,0,-32
1771,1,0,22,0,-22
1772,1,0,70,0,-70
1773,1,1,403,1304,901
1774,1,0,75,0,-75
1775,1,0,71,0,-71
1776,0,0,28,0,-28
1777,0,0,34,0,-34
1778,1,1,615,2295,1680
1779,1,0,10,0,-10
1780,0,0,36,0,-36
1781,1,1,101,2170,2069
1782,1,1,379,1600,1221
1783,1,1,318,1316,998
1784,0,0,24,0,-24
1785,0,0,32,0,-32
1786,1,1,330,1304,974
1787,0,0,2,0,-2
1788,1,1,520,1710,1190
1789,0,0,2,0,-2
1790,0,0,221,0,-221
1791,1,1,156,1272,1116
1792,0,0,22,0,-22
1793,0,0,47,0,-47
1794,1,0,108,0,-108
1795,0,0,25,0,-25
1796,0,0,6,0,-6
1797,1,0,34,0,-34
1798,1,0,18,0,-18
1799,1,0,4,0,-4
1800,0,0,6,0,-6
1801,1,1,173,1727,1554
1802,1,1,1660,1717,57
1803,1,1,900,2053,1153
1804,1,1,217,1383,1166
1805,1,1,239,1545,1306
1806,0,0,47,0,-47
1807,0,0,7,0,-7
1808,0,0,102,0,-102
1809,0,0,93,0,-93
1810,0,0,87,0,-87
1811,0,0,40,0,-40
1812,0,0,40,0,-40
1813,1,0,1,0,-1
1814,1,1,140,1216,1076
1815,0,0,12,0,-12
1816,1,1,771,1634,863
1817,0,0,100,0,-100
1818,0,0,51,0,-51
1819,1,0,9,0,-9
1820,0,0,73,0,-73
1821,0,0,7,0,-7
1822,1,0,218,0,-218
1823,0,0,4,0,-4
1824,0,0,3,0,-3
1825,1,0,14,0,-14
1826,1,1,260,1536,1276
1827,0,0,24,0,-24
1828,0,0,114,0,-114
1829,1,1,79,1324,1245
1830,0,0,47,0,-47
1831,1,1,116,1268,1152
1832,1,1,660,1249,589
1833,1,1,371,1300,929
1834,1,0,33,0,-33
1835,1,1,478,3691,3213
1836,1,1,106,1963,1857
1837,0,0,3,0,-3
1838,0,0,59,0,-59
1839,1,1,237,1269,1032
1840,1,1,976,1218,242
1841,0,0,9,0,-9
1842,0,0,70,0,-70
1843,1,1,1518,1670,152
1844,1,0,37,0,-37
1845,0,0,43,0,-43
1846,1,0,20,0,-20
1847,0,0,107,0,-107
1848,0,0,80,0,-80
1849,0,0,5,0,-5
1850,0,0,67,0,-67
1851,0,0,29,0,-29
1852,1,1,401,1283,882
1853,0,0,57,0,-57
1854,1,0,16,0,-16
1855,1,1,488,1567,1079
1856,1,0,17,0,-17
1857,1,1,117,1614,1497
1858,0,0,4,0,-4
1859,1,1,1074,1246,172
1860,0,0,24,0,-24
1861,0,0,152,0,-152
1862,0,0,6,0,-6
1863,0,0,144,0,-144
1864,0,0,169,0,-169
1865,0,0,29,0,-29
1866,1,0,22,0,-22
1867,0,0,12,0,-12
1868,0,0,24,0,-24
1869,1,0,46,0,-46
1870,0,0,1,0,-1
1871,1,0,40,0,-40
1872,0,0,91,0,-91
1873,1,1,307,1700,1393
1874,1,0,68,0,-68
1875,1,1,838,4439,3601
1876,1,1,619,1543,924
1877,0,0,9,0,-9
1878,1,0,75,0,-75
1879,1,0,59,0,-59
1880,0,0,10,0,-10
1881,0,0,121,0,-121
1882,0,0,99,0,-99
1883,1,0,17,0,-17
1884,1,1,535,2041,1506
1885,0,0,18,0,-18
1886,1,1,509,1227,718
1887,1,1,1186,1606,420
1888,1,0,2,0,-2
1889,0,0,0,0,0
1890,0,0,4,0,-4
1891,1,1,393,2638,2245
1892,0,0,29,0,-29
1893,1,1,281,1360,1079
1894,1,1,979,1295,316
1895,1,0,18,0,-18
1896,0,0,5,0,-5
1897,1,0,56,0,-56
1898,1,1,595,3074,2479
1899,1,1,136,2033,1897
1900,1,0,137,0,-137
1901,0,0,82,0,-82
1902,1,0,22,0,-22
1903,1,0,16,0,-16
1904,1,0,10,0,-10
1905,1,1,2267,1233,-1034
1906,1,1,979,1530,551
1907,0,0,2,0,-2
1908,1,0,197,0,-197
1909,0,0,4,0,-4
1910,1,1,2409,1200,-1209
1911,0,0,92,0,-92
1912,1,1,409,1240,831
1913,1,1,1164,1213,49
1914,1,0,49,0,-49
1915,0,0,69,0,-69
1916,1,0,74,0,-74
1917,1,0,10,0,-10
1918,1,0,67,0,-67
1919,0,0,83,0,-83
1920,0,0,14,0,-14
1921,1,0,34,0,-34
1922,0,0,44,0,-44
1923,0,0,30,0,-30
1924,0,0,125,0,-125
1925,0,0,21,0,-21
1926,1,1,422,1304,882
1927,1,0,1,0,-1
1928,1,0,21,0,-21
1929,1,1,549,1408,859
1930,1,1,3007,1230,-1777
1931,0,0,24,0,-24
1932,0,0,3,0,-3
1933,1,0,43,0,-43
1934,0,0,126,0,-126
1935,1,0,46,0,-46
1936,0,0,7,0,-7
1937,0,0,28,0,-28
1938,1,1,2278,1273,-1005
1939,1,0,38,0,-38
1940,0,0,81,0,-81
1941,0,0,153,0,-153
1942,0,0,23,0,-23
1943,1,0,13,0,-13
1944,1,1,918,2731,1813
1945,0,0,51,0,-51
1946,1,0,83,0,-83
1947,1,1,276,1415,1139
1948,1,1,478,1218,740
1949,1,0,5,0,-5
1950,0,0,201,0,-201
1951,0,0,26,0,-26
1952,0,0,9,0,-9
1953,0,0,87,0,-87
1954,1,1,46,1855,1809
1955,1,1,655,2222,1567
1956,0,0,39,0,-39
1957,0,0,23,0,-23
1958,1,1,298,1237,939
1959,1,1,577,2590,2013
1960,1,1,155,1495,1340
1961,1,1,1309,1560,251
1962,1,1,548,1526,978
1963,0,0,172,0,-172
1964,0,0,4,0,-4
1965,1,1,162,2530,2368
1966,1,1,557,1377,820
1967,1,0,124,0,-124
1968,0,0,74,0,-74
1969,1,0,1,0,-1
1970,1,0,20,0,-20
1971,0,0,266,0,-266
1972,0,0,47,0,-47
1973,1,1,176,1253,1077
1974,1,1,284,1275,991
1975,1,0,56,0,-56
1976,1,0,36,0,-36
1977,1,1,91,1571,1480
1978,0,0,75,0,-75
1979,0,0,57,0,-57
1980,1,1,1310,1344,34
1981,0,0,108,0,-108
1982,1,0,12,0,-12
1983,1,1,1275,1414,139
1984,1,1,629,1353,724
1985,0,0,60,0,-60
1986,1,1,477,1661,1184
1987,1,0,61,0,-61
1988,1,0,41,0,-41
1989,1,1,465,1293,828
1990,0,0,46,0,-46
1991,1,1,380,1233,853
1992,0,0,9,0,-9
1993,0,0,71,0,-71
1994,1,0,0,0,0
1995,0,0,91,0,-91
1996,1,1,802,1226,424
1997,1,0,83,0,-83
1998,0,0,8,0,-8
1999,1,1,196,1230,1034
2000,0,0,111,0,-111
2001,0,0,1,0,-1
2002,1,0,4,0,-4
2003,0,0,8,0,-8
2004,0,0,10,0,-10
2005,1,1,54,1472,1418
2006,0,0,56,0,-56
2007,1,0,2,0,-2
2008,1,0,239,0,-239
2009,1,1,1226,1466,240
2010,1,0,9,0,-9
2011,0,0,20,0,-20
2012,1,0,67,0,-67
2013,0,0,46,0,-46
2014,1,0,37,0,-37
2015,1,1,833,1410,577
2016,1,1,201,1644,1443
2017,1,0,20,0,-20
2018,0,0,16,0,-16
2019,0,0,47,0,-47
2020,1,1,115,1385,1270
2021,0,0,5,0,-5
2022,1,0,32,0,-32
2023,1,1,369,1267,898
2024,0,0,17,0,-17
2025,0,0,123,0,-123
2026,1,1,2354,1494,-860
2027,1,1,394,1534,1140
2028,1,1,206,1529,1323
2029,0,0,166,0,-166
2030,1,1,231,1412,1181
2031,1,0,22,0,-22
2032,0,0,66,0,-66
2033,1,1,521,1577,1056
2034,1,1,701,1569,868
2035,1,0,36,0,-36
2036,1,1,526,1354,828
2037,0,0,2,0,-2
2038,0,0,27,0,-27
2039,0,0,12,0,-12
2040,0,0,3,0,-3
2041,0,0,19,0,-19
2042,1,0,160,0,-160
2043,1,0,83,0,-83
2044,0,0,34,0,-34
2045,1,1,244,1534,1290
2046,1,0,24,0,-24
2047,1,0,33,0,-33
2048,0,0,24,0,-24
2049,0,0,33,0,-33
2050,1,1,596,1600,1004
2051,0,0,20,0,-20
2052,0,0,42,0,-42
2053,0,0,2,0,-2
2054,1,0,20,0,-20
2055,1,0,7,0,-7
2056,1,0,97,0,-97
2057,1,0,29,0,-29
2058,1,0,3,0,-3
2059,0,0,56,0,-56
2060,1,0,38,0,-38
2061,1,1,192,1364,1172
2062,0,0,8,0,-8
2063,0,0,73,0,-73
2064,1,0,18,0,-18
2065,0,0,259,0,-259
2066,0,0,32,0,-32
2067,1,1,486,2066,1580
2068,0,0,21,0,-21
2069,1,0,60,0,-60
2070,1,0,12,0,-12
2071,0,0,30,0,-30
2072,1,0,26,0,-26
2073,1,0,50,0,-50
2074,1,1,1171,2123,952
2075,1,1,497,1277,780
2076,1,1,93,2165,2072
2077,1,0,173,0,-173
2078,1,1,238,1264,1026
2079,0,0,39,0,-39
2080,1,1,550,1542,992
2081,1,1,210,1422,1212
2082,1,1,1177,1522,345
2083,0,0,49,0,-49
2084,1,0,28,0,-28
2085,0,0,0,0,0
2086,1,0,5,0,-5
2087,1,0,14,0,-14
2088,0,0,18,0,-18
2089,0,0,42,0,-42
2090,0,0,23,0,-23
2091,1,1,279,1538,1259
2092,1,0,76,0,-76
2093,0,0,83,0,-83
2094,0,0,16,0,-16
2095,1,0,28,0,-28
2096,0,0,91,0,-91
2097,1,0,72,0,-72
2098,1,0,220,0,-220
2099,0,0,46,0,-46
2100,1,0,12,0,-12
2101,0,0,51,0,-51
2102,1,1,390,1582,1192
2103,1,1,802,1225,423
2104,1,1,112,1542,1430
2105,1,0,27,0,-27
2106,0,0,68,0,-68
2107,1,1,929,1274,345
2108,1,1,398,1388,990
2109,0,0,9,0,-9
2110,1,0,104,0,-104
2111,0,0,295,0,-295
2112,0,0,0,0,0
2113,0,0,1,0,-1
2114,1,1,149,1208,1059
2115,1,1,120,1334,1214
2116,0,0,92,0,-92
2117,0,0,4,0,-4
2118,1,0,3,0,-3
2119,1,0,69,0,-69
2120,0,0,19,0,-19
2121,1,1,518,1550,1032
2122,1,1,606,1625,1019
2123,0,0,22,0,-22
2124,1,0,15,0,-15
2125,1,1,117,1339,1222
2126,0,0,4,0,-4
2127,1,0,53,0,-53
2128,0,0,68,0,-68
2129,1,0,147,0,-147
2130,1,1,269,2040,1771
2131,1,0,66,0,-66
2132,0,0,25,0,-25
2133,1,1,454,1585,1131
2134,0,0,77,0,-77
2135,0,0,31,0,-31
2136,1,0,42,0,-42
2137,1,1,186,1305,1119
2138,1,0,7,0,-7
2139,0,0,213,0,-213
2140,1,0,1,0,-1
2141,1,0,85,0,-85
2142,0,0,73,0,-73
2143,0,0,17,0,-17
2144,0,0,23,0,-23
2145,0,0,90,0,-90
2146,1,1,467,1208,741
2147,1,0,18,0,-18
2148,1,1,237,1422,1185
2149,1,0,223,0,-223
2150,0,0,13,0,-13
2151,0,0,8,0,-8
2152,0,0,61,0,-61
2153,0,0,88,0,-88
2154,1,0,57,0,-57
2155,1,1,861,1805,944
2156,1,1,137,1208,1071
2157,0,0,43,0,-43
2158,0,0,52,0,-52
2159,1,0,8,0,-8
2160,0,0,1,0,-1
2161,1,1,1501,1784,283
2162,1,1,84,1395,1311
2163,1,0,162,0,-162
2164,0,0,150,0,-150
2165,1,0,194,0,-194
2166,0,0,32,0,-32
2167,1,1,423,1233,810
2168,1,1,244,1606,1362
2169,1,0,21,0,-21
2170,0,0,3,0,-3
2171,0,0,1,0,-1
2172,1,0,163,0,-163
2173,1,1,94,1306,1212
2174,1,1,645,1228,583
2175,1,0,9,0,-9
2176,1,1,536,1410,874
2177,1,0,24,0,-24
2178,0,0,10,0,-10
2179,0,0,5,0,-5
2180,1,1,594,1794,1200
2181,1,0,29,0,-29
2182,0,0,165,0,-165
2183,1,1,1238,1643,405
2184,0,0,93,0,-93
2185,1,0,112,0,-112
2186,0,0,96,0,-96
2187,1,1,396,1212,816
2188,1,1,275,1239,964
2189,0,0,13,0,-13
2190,0,0,5,0,-5
2191,1,1,59,1486,1427
2192,1,0,24,0,-24
2193,1,0,10,0,-10
2194,1,0,25,0,-25
2195,0,0,87,0,-87
2196,1,1,576,1258,682
2197,1,1,684,1249,565
2198,1,0,72,0,-72
2199,0,0,25,0,-25
2200,1,0,24,0,-24
2201,0,0,46,0,-46
2202,0,0,10,0,-10
2203,1,0,10,0,-10
2204,1,0,48,0,-48
2205,1,1,406,1249,843
2206,0,0,58,0,-58
2207,1,0,54,0,-54
2208,1,0,66,0,-66
2209,0,0,28,0,-28
2210,1,0,70,0,-70
2211,1,0,42,0,-42
2212,1,0,31,0,-31
2213,0,0,216,0,-216
2214,1,0,17,0,-17
2215,1,1,248,1393,1145
2216,0,0,174,0,-174
2217,1,0,119,0,-119
2218,1,1,579,1335,756
2219,1,0,3,0,-3
2220,1,0,85,0,-85
2221,1,1,323,1300,977
2222,1,1,132,1350,1218
2223,1,0,70,0,-70
2224,0,0,82,0,-82
2225,1,0,10,0,-10
2226,1,0,21,0,-21
2227,0,0,55,0,-55
2228,0,0,8,0,-8
2229,0,0,317,0,-317
2230,1,0,5,0,-5
2231,0,0,10,0,-10
2232,1,0,6,0,-6
2233,0,0,15,0,-15
2234,0,0,32,0,-32
2235,1,0,106,0,-106
2236,1,0,31,0,-31
2237,0,0,0,0,0
2238,1,0,171,0,-171
2239,1,1,720,1572,852
2240,1,1,407,1396,989
2241,0,0,10,0,-10
2242,1,1,148,1401,1253
2243,0,0,75,0,-75
2244,0,0,14,0,-14
2245,1,0,1,0,-1
2246,1,0,12,0,-12
2247,0,0,1,0,-1
2248,0,0,1,0,-1
2249,0,0,43,0,-43
2250,0,0,54,0,-54
2251,1,0,1,0,-1
2252,1,0,24,0,-24
2253,1,0,135,0,-135
2254,0,0,3,0,-3
2255,0,0,52,0,-52
2256,0,0,12,0,-12
2257,0,0,56,0,-56
2258,1,1,321,1339,1018
2259,1,1,887,1429,542
2260,0,0,60,0,-60
2261,1,1,2125,1331,-794
2262,0,0,29,0,-29
2263,0,0,21,0,-21
2264,1,0,51,0,-51
2265,0,0,49,0,-49
2266,1,0,23,0,-23
2267,1,1,136,1312,1176
2268,1,0,86,0,-86
2269,1,1,337,1275,938
2270,1,1,42,2063,2021
2271,1,1,143,1313,1170
2272,1,0,72,0,-72
2273,1,0,13,0,-13
2274,1,1,6,1843,1837
2275,1,1,897,1211,314
2276,0,0,44,0,-44
2277,0,0,6,0,-6
2278,0,0,80,0,-80
2279,1,1,297,1805,1508
2280,1,1,768,1235,467
2281,1,1,380,2008,1628
2282,0,0,127,0,-127
2283,1,1,200,2442,2242
2284,0,0,45,0,-45
2285,0,0,18,0,-18
2286,0,0,128,0,-128
2287,0,0,141,0,-141
2288,0,0,28,0,-28
2289,1,1,83,1339,1256
2290,1,0,20,0,-20
2291,0,0,6,0,-6
2292,1,1,362,1220,858
2293,0,0,52,0,-52
2294,1,1,420,1237,817
2295,0,0,5,0,-5
2296,1,1,548,1279,731
2297,1,1,609,1322,713
2298,1,0,44,0,-44
2299,1,0,11,0,-11
2300,1,0,9,0,-9
2301,1,1,1037,3174,2137
2302,1,1,170,1928,1758
2303,1,1,161,1332,1171
2304,1,0,34,0,-34
2305,0,0,7,0,-7
2306,1,1,1575,1337,-238
2307,1,0,17,0,-17
2308,0,0,102,0,-102
2309,1,0,15,0,-15
2310,1,0,58,0,-58
2311,1,0,150,0,-150
2312,0,0,16,0,-16
2313,1,0,6,0,-6
2314,1,0,17,0,-17
2315,1,0,40,0,-40
2316,1,0,52,0,-52
2317,1,0,18,0,-18
2318,1,0,154,0,-154
2319,1,0,18,0,-18
2320,1,0,42,0,-42
2321,1,0,34,0,-34
2322,0,0,95,0,-95
2323,1,1,460,1326,866
2324,0,0,110,0,-110
2325,1,1,69,1635,1566
2326,0,0,96,0,-96
2327,1,1,61,1622,1561
2328,1,0,78,0,-78
2329,1,0,92,0,-92
2330,0,0,4,0,-4
2331,0,0,54,0,-54
2332,0,0,37,0,-37
2333,1,1,146,1241,1095
2334,1,0,4,0,-4
2335,1,0,52,0,-52
2336,1,1,422,1230,808
2337,1,0,62,0,-62
2338,1,0,69,0,-69
2339,1,1,427,1376,949
2340,1,1,109,1451,1342
2341,1,0,13,0,-13
2342,1,0,36,0,-36
2343,0,0,20,0,-20
2344,1,1,503,1554,1051
2345,1,0,42,0,-42
2346,1,1,723,1494,771
2347,0,0,66,0,-66
2348,1,1,880,1274,394
2349,0,0,32,0,-32
2350,0,0,26,0,-26
2351,0,0,114,0,-114
2352,1,0,10,0,-10
2353,0,0,50,0,-50
2354,0,0,2,0,-2
2355,0,0,16,0,-16
2356,1,1,50,1837,1787
2357,0,0,46,0,-46
2358,1,1,145,1318,1173
2359,1,1,241,1279,1038
2360,0,0,73,0,-73
2361,1,1,974,1210,236
2362,1,0,0,0,0
2363,1,1,140,1329,1189
2364,0,0,50,0,-50
2365,0,0,72,0,-72
2366,0,0,1,0,-1
2367,0,0,26,0,-26
2368,1,1,373,1542,1169
2369,0,0,55,0,-55
2370,1,0,57,0,-57
2371,1,1,1298,1626,328
2372,0,0,51,0,-51
2373,1,1,507,1792,1285
2374,0,0,31,0,-31
2375,0,0,3,0,-3
2376,0,0,26,0,-26
2377,1,1,192,1254,1062
2378,1,0,51,0,-51
2379,0,0,43,0,-43
2380,0,0,37,0,-37
2381,1,1,418,1926,1508
2382,0,0,115,0,-115
2383,1,1,441,1295,854
2384,1,1,45,1565,1520
2385,1,1,1063,2026,963
2386,1,0,27,0,-27
2387,0,0,60,0,-60
2388,1,1,199,1278,1079
2389,1,0,32,0,-32
2390,1,1,1120,2154,1034
2391,0,0,77,0,-77
2392,0,0,99,0,-99
2393,0,0,0,0,0
2394,0,0,29,0,-29
2395,1,1,72,1481,1409
2396,1,0,76,0,-76
2397,1,1,677,1349,672
2398,1,1,1759,1342,-417
2399,1,0,113,0,-113
2400,1,1,186,1352,1166
2401,1,1,712,2121,1409
2402,1,0,20,0,-20
2403,1,1,561,1619,1058
2404,0,0,27,0,-27
2405,1,1,603,1974,1371
2406,1,0,11,0,-11
2407,0,0,81,0,-81
2408,1,1,745,1441,696
2409,0,0,44,0,-44
2410,0,0,61,0,-61
2411,1,0,2,0,-2
2412,1,1,488,1719,1231
2413,1,1,356,1278,922
2414,0,0,87,0,-87
2415,0,0,87,0,-87
2416,1,0,11,0,-11
2417,1,0,57,0,-57
2418,1,1,403,1800,1397
2419,0,0,30,0,-30
2420,1,1,297,1576,1279
2421,1,0,104,0,-104
2422,1,1,1384,1211,-173
2423,1,1,71,1252,1181
2424,0,0,14,0,-14
2425,1,0,4,0,-4
2426,0,0,17,0,-17
2427,1,0,156,0,-156
2428,0,0,18,0,-18
2429,1,0,80,0,-80
2430,0,0,54,0,-54
2431,1,0,93,0,-93
2432,0,0,65,0,-65
2433,0,0,36,0,-36
2434,1,0,15,0,-15
2435,1,0,9,0,-9
2436,0,0,48,0,-48
2437,1,0,33,0,-33
2438,1,0,115,0,-115
2439,1,0,2,0,-2
2440,1,1,141,1239,1098
2441,1,0,15,0,-15
2442,1,1,1155,1337,182
2443,1,1,469,3284,2815
2444,0,0,139,0,-139
2445,1,1,676,2059,1383
2446,1,0,5,0,-5
2447,0,0,17,0,-17
2448,0,0,42,0,-42
2449,1,0,116,0,-116
2450,1,0,12,0,-12
2451,0,0,1,0,-1
2452,1,0,97,0,-97
2453,0,0,47,0,-47
2454,0,0,45,0,-45
2455,1,1,1931,1236,-695
2456,1,1,553,1378,825
2457,0,0,31,0,-31
2458,0,0,27,0,-27
2459,0,0,119,0,-119
2460,0,0,5,0,-5
2461,1,0,3,0,-3
2462,1,1,88,1473,1385
2463,1,0,45,0,-45
2464,0,0,82,0,-82
2465,1,0,12,0,-12
2466,1,1,772,1264,492
2467,1,1,1379,1266,-113
2468,0,0,5,0,-5
2469,1,0,8,0,-8
2470,0,0,51,0,-51
2471,0,0,33,0,-33
2472,1,0,33,0,-33
2473,1,0,121,0,-121
2474,1,0,67,0,-67
2475,0,0,20,0,-20
2476,1,1,1153,2722,1569
2477,1,0,16,0,-16
2478,0,0,19,0,-19
2479,0,0,33,0,-33
2480,1,1,185,1391,1206
2481,1,0,10,0,-10
2482,0,0,44,0,-44
2483,1,0,9,0,-9
2484,1,0,1,0,-1
2485,1,1,420,1203,783
2486,0,0,65,0,-65
2487,1,0,0,0,0
2488,1,1,677,1587,910
2489,1,0,39,0,-39
2490,0,0,10,0,-10
2491,0,0,63,0,-63
2492,0,0,29,0,-29
2493,1,0,5,0,-5
2494,1,0,167,0,-167
2495,0,0,73,0,-73
2496,1,1,338,1322,984
2497,1,1,383,1370,987
2498,1,0,19,0,-19
2499,0,0,91,0,-91
2500,1,0,66,0,-66
2501,1,1,726,1526,800
2502,1,0,43,0,-43
2503,1,0,31,0,-31
2504,1,0,78,0,-78
2505,0,0,19,0,-19
2506,0,0,132,0,-132
2507,0,0,91,0,-91
2508,1,1,247,1404,1157
2509,1,0,10,0,-10
2510,1,0,41,0,-41
2511,1,1,3667,1788,-1879
2512,1,0,1,0,-1
2513,1,1,1386,1211,-175
2514,1,0,27,0,-27
2515,1,0,63,0,-63
2516,1,0,103,0,-103
2517,0,0,29,0,-29
2518,1,0,37,0,-37
2519,1,1,307,2644,2337
2520,1,1,692,1626,934
2521,1,0,113,0,-113
2522,1,1,600,1352,752
2523,1,0,31,0,-31
2524,0,0,60,0,-60
2525,1,0,14,0,-14
2526,0,0,19,0,-19
2527,1,1,248,3021,2773
2528,1,1,62,1511,1449
2529,1,1,467,1406,939
2530,1,0,3,0,-3
2531,1,0,25,0,-25
2532,0,0,47,0,-47
2533,1,1,1139,1231,92
2534,1,1,409,2766,2357
2535,1,0,92,0,-92
2536,1,0,1,0,-1
2537,0,0,9,0,-9
2538,0,0,120,0,-120
2539,0,0,143,0,-143
2540,1,0,5,0,-5
2541,0,0,34,0,-34
2542,1,0,98,0,-98
2543,1,1,254,1501,1247
2544,1,1,415,1250,835
2545,1,1,1787,1417,-370
2546,1,1,302,1293,991
2547,0,0,201,0,-201
2548,1,1,346,1412,1066
2549,1,1,255,1259,1004
2550,0,0,6,0,-6
2551,0,0,105,0,-105
2552,1,0,126,0,-126
2553,1,1,1313,1253,-60
2554,1,0,24,0,-24
2555,1,1,403,1216,813
2556,0,0,233,0,-233
2557,1,0,79,0,-79
2558,1,0,46,0,-46
2559,0,0,26,0,-26
2560,0,0,23,0,-23
2561,1,0,56,0,-56
2562,1,1,194,1244,1050
2563,0,0,44,0,-44
2564,1,1,826,1210,384
2565,0,0,6,0,-6
2566,1,0,58,0,-58
2567,1,1,251,1338,1087
2568,0,0,22,0,-22
2569,0,0,85,0,-85
2570,1,0,14,0,-14
2571,1,0,46,0,-46
2572,1,1,440,1595,1155
2573,1,0,26,0,-26
2574,0,0,18,0,-18
2575,1,0,9,0,-9
2576,1,0,52,0,-52
2577,0,0,4,0,-4
2578,1,1,128,1602,1474
2579,1,0,21,0,-21
2580,0,0,34,0,-34
2581,0,0,5,0,-5
2582,0,0,49,0,-49
2583,0,0,4,0,-4
2584,0,0,232,0,-232
2585,1,0,76,0,-76
2586,0,0,2,0,-2
2587,1,1,152,1534,1382
2588,0,0,27,0,-27
2589,0,0,7,0,-7
2590,0,0,34,0,-34
2591,1,1,61,1446,1385
2592,0,0,23,0,-23
2593,1,1,677,1932,1255
2594,0,0,49,0,-49
2595,0,0,5,0,-5
2596,0,0,9,0,-9
2597,0,0,109,0,-109
2598,1,1,177,1469,1292
2599,0,0,47,0,-47
2600,1,0,1,0,-1
2601,1,1,818,1548,730
2602,0,0,82,0,-82
2603,0,0,11,0,-11
2604,1,0,39,0,-39
2605,1,0,130,0,-130
2606,0,0,64,0,-64
2607,1,0,4,0,-4
2608,1,1,391,1666,1275
2609,1,1,389,1303,914
2610,0,0,21,0,-21
2611,0,0,75,0,-75
2612,1,0,18,0,-18
2613,1,0,45,0,-45
2614,0,0,34,0,-34
2615,1,0,34,0,-34
2616,1,0,24,0,-24
2617,0,0,47,0,-47
2618,1,1,215,2029,1814
2619,1,1,1735,1441,-294
2620,1,1,881,1397,516
2621,1,0,85,0,-85
2622,0,0,85,0,-85
2623,1,1,71,1271,1200
2624,1,1,1025,1745,720
2625,1,1,259,1830,1571
2626,0,0,80,0,-80
2627,0,0,74,0,-74
2628,0,0,219,0,-219
2629,1,0,50,0,-50
2630,0,0,29,0,-29
2631,0,0,32,0,-32
2632,1,1,778,1255,477
2633,0,0,1,0,-1
2634,1,0,19,0,-19
2635,1,0,95,0,-95
2636,1,0,40,0,-40
2637,1,0,16,0,-16
2638,1,0,24,0,-24
2639,1,0,0,0,0
2640,0,0,3,0,-3
2641,0,0,32,0,-32
2642,0,0,6,0,-6
2643,1,1,289,1501,1212
2644,0,0,72,0,-72
2645,1,1,869,1228,359
2646,1,0,9,0,-9
2647,1,0,7,0,-7
2648,0,0,346,0,-346
2649,0,0,133,0,-133
2650,0,0,141,0,-141
2651,1,0,63,0,-63
2652,1,1,149,1596,1447
2653,1,0,52,0,-52
2654,1,1,367,1788,1421
2655,1,1,53,1202,1149
2656,1,0,3,0,-3
2657,0,0,1,0,-1
2658,1,0,24,0,-24
2659,0,0,30,0,-30
2660,1,0,83,0,-83
2661,1,1,382,1273,891
2662,0,0,35,0,-35
2663,1,0,31,0,-31
2664,0,0,3,0,-3
2665,0,0,67,0,-67
2666,0,0,93,0,-93
2667,0,0,11,0,-11
2668,1,1,43,1402,1359
2669,1,0,43,0,-43
2670,1,0,4,0,-4
2671,1,1,896,1558,662
2672,1,0,82,0,-82
2673,1,0,11,0,-11
2674,1,0,35,0,-35
2675,1,0,72,0,-72
2676,0,0,13,0,-13
2677,0,0,133,0,-133
2678,1,0,6,0,-6
2679,0,0,15,0,-15
2680,1,1,320,1623,1303
2681,1,0,59,0,-59
2682,1,1,183,1589,1406
2683,0,0,11,0,-11
2684,0,0,14,0,-14
2685,0,0,14,0,-14
2686,1,0,31,0,-31
2687,1,0,111,0,-111
2688,1,0,1,0,-1
2689,0,0,65,0,-65
2690,1,1,352,1297,945
2691,1,0,27,0,-27
2692,0,0,22,0,-22
2693,0,0,45,0,-45
2694,0,0,65,0,-65
2695,0,0,5,0,-5
2696,0,0,16,0,-16
2697,1,1,2121,1315,-806
2698,1,0,62,0,-62
2699,0,0,38,0,-38
2700,1,0,4,0,-4
2701,0,0,50,0,-50
2702,1,1,347,1544,1197
2703,1,1,129,1340,1211
2704,0,0,44,0,-44
2705,1,0,117,0,-117
2706,0,0,76,0,-76
2707,1,1,883,1381,498
2708,1,0,54,0,-54
2709,1,0,44,0,-44
2710,0,0,14,0,-14
2711,1,0,138,0,-138
2712,1,1,532,2224,1692
2713,1,1,1605,1466,-139
2714,0,0,38,0,-38
2715,1,0,156,0,-156
2716,1,0,210,0,-210
2717,0,0,15,0,-15
2718,1,0,6,0,-6
2719,1,0,31,0,-31
2720,1,0,1,0,-1
2721,0,0,59,0,-59
2722,1,1,632,1803,1171
2723,1,1,1284,1254,-30
2724,0,0,134,0,-134
2725,0,0,17,0,-17
2726,0,0,14,0,-14
2727,1,0,16,0,-16
2728,1,1,322,1789,1467
2729,1,0,144,0,-144
2730,1,0,9,0,-9
2731,1,0,60,0,-60
2732,0,0,100,0,-100
2733,1,1,460,1660,1200
2734,1,0,47,0,-47
2735,0,0,33,0,-33
2736,0,0,23,0,-23
2737,0,0,6,0,-6
2738,1,1,151,1220,1069
2739,1,0,85,0,-85
2740,0,0,8,0,-8
2741,0,0,9,0,-9
2742,1,1,276,1207,931
2743,0,0,127,0,-127
2744,1,1,64,1219,1155
2745,0,0,4,0,-4
2746,0,0,19,0,-19
2747,0,0,9,0,-9
2748,1,0,76,0,-76
2749,1,1,204,1394,1190
2750,1,0,42,0,-42
2751,1,0,22,0,-22
2752,1,1,700,1352,652
2753,0,0,0,0,0
2754,1,0,22,0,-22
2755,1,0,157,0,-157
2756,0,0,80,0,-80
2757,1,1,859,2041,1182
2758,1,1,34,1326,1292
2759,1,0,26,0,-26
2760,1,1,1217,1395,178
2761,1,0,30,0,-30
2762,0,0,32,0,-32
2763,1,0,14,0,-14
2764,0,0,79,0,-79
2765,1,1,201,1745,1544
2766,0,0,8,0,-8
2767,1,1,1245,2126,881
2768,1,0,61,0,-61
2769,1,1,593,1381,788
2770,0,0,26,0,-26
2771,1,1,86,1424,1338
2772,1,1,136,1347,1211
2773,1,1,154,1431,1277
2774,1,1,64,1992,1928
2775,1,0,1,0,-1
2776,0,0,21,0,-21
2777,1,0,71,0,-71
2778,1,0,57,0,-57
2779,0,0,59,0,-59
2780,0,0,88,0,-88
2781,0,0,95,0,-95
2782,0,0,94,0,-94
2783,0,0,29,0,-29
2784,0,0,65,0,-65
2785,0,0,57,0,-57
2786,0,0,8,0,-8
2787,1,0,17,0,-17
2788,0,0,131,0,-131
2789,0,0,18,0,-18
2790,1,0,8,0,-8
2791,1,0,136,0,-136
2792,0,0,114,0,-114
2793,1,1,393,1588,1195
2794,1,1,132,1445,1313
2795,0,0,56,0,-56
2796,1,1,274,2374,2100
2797,0,0,53,0,-53
2798,1,0,30,0,-30
2799,1,1,215,2457,2242
2800,1,0,6,0,-6
2801,0,0,44,0,-44
2802,1,1,116,1303,1187
2803,1,1,2926,1242,-1684
2804,1,0,17,0,-17
2805,1,0,4,0,-4
2806,1,1,1319,1261,-58
2807,1,1,895,1267,372
2808,0,0,8,0,-8
2809,1,0,61,0,-61
2810,1,1,419,1464,1045
2811,0,0,395,0,-395
2812,1,1,178,1665,1487
2813,1,0,33,0,-33
2814,1,1,282,1232,950
2815,1,1,335,2425,2090
2816,0,0,15,0,-15
2817,0,0,51,0,-51
2818,0,0,15,0,-15
2819,1,1,654,1275,621
2820,1,0,27,0,-27
2821,1,1,307,1375,1068
2822,0,0,69,0,-69
2823,1,0,0,0,0
2824,0,0,5,0,-5
2825,1,1,921,1666,745
2826,1,0,27,0,-27
2827,1,0,182,0,-182
2828,1,1,329,1786,1457
2829,1,1,93,1208,1115
2830,0,0,49,0,-49
2831,1,0,29,0,-29
2832,0,0,54,0,-54
2833,0,0,159,0,-159
2834,0,0,17,0,-17
2835,1,1,93,1543,1450
2836,0,0,20,0,-20
2837,1,0,139,0,-139
2838,0,0,128,0,-128
2839,1,1,552,1326,774
2840,1,0,48,0,-48
2841,1,0,14,0,-14
2842,0,0,13,0,-13
2843,0,0,4,0,-4
2844,1,0,39,0,-39
2845,1,1,1076,2508,1432
2846,1,1,1509,1685,176
2847,0,0,64,0,-64
2848,1,0,6,0,-6
2849,1,0,74,0,-74
2850,0,0,29,0,-29
2851,1,1,761,1504,743
2852,0,0,34,0,-34
2853,1,1,271,1276,1005
2854,1,1,1687,3489,1802
2855,0,0,30,0,-30
2856,1,0,112,0,-112
2857,1,1,324,1290,966
2858,0,0,5,0,-5
2859,1,0,9,0,-9
2860,0,0,63,0,-63
2861,1,1,441,1411,970
2862,1,0,20,0,-20
2863,1,1,770,1644,874
2864,1,1,1151,1548,397
2865,1,0,40,0,-40
2866,0,0,30,0,-30
2867,1,0,88,0,-88
2868,0,0,13,0,-13
2869,0,0,78,0,-78
2870,1,0,6,0,-6
2871,0,0,82,0,-82
2872,1,1,177,1214,1037
2873,0,0,1,0,-1
2874,0,0,64,0,-64
2875,1,0,5,0,-5
2876,1,0,131,0,-131
2877,0,0,82,0,-82
2878,0,0,17,0,-17
2879,1,0,67,0,-67
2880,1,0,47,0,-47
2881,1,0,3,0,-3
2882,1,1,432,1759,1327
2883,1,0,8,0,-8
2884,1,1,365,1488,1123
2885,1,0,14,0,-14
2886,0,0,65,0,-65
2887,0,0,131,0,-131
2888,1,0,146,0,-146
2889,1,1,46,1282,1236
2890,0,0,43,0,-43
2891,0,0,86,0,-86
2892,0,0,6,0,-6
2893,1,1,424,2224,1800
2894,0,0,97,0,-97
2895,1,1,346,2371,2025
2896,1,0,6,0,-6
2897,0,0,33,0,-33
2898,0,0,26,0,-26
2899,0,0,9,0,-9
2900,0,0,33,0,-33
2901,0,0,56,0,-56
2902,0,0,53,0,-53
2903,0,0,45,0,-45
2904,0,0,27,0,-27
2905,1,0,15,0,-15
2906,0,0,91,0,-91
2907,1,0,2,0,-2
2908,1,0,50,0,-50
2909,0,0,30,0,-30
2910,1,0,13,0,-13
2911,1,1,494,2360,1866
2912,0,0,100,0,-100
2913,1,1,1009,1365,356
2914,1,1,487,1344,857
2915,0,0,36,0,-36
2916,0,0,14,0,-14
2917,1,0,16,0,-16
2918,1,0,41,0,-41
2919,1,1,759,1444,685
2920,0,0,49,0,-49
2921,1,0,11,0,-11
2922,0,0,66,0,-66
2923,0,0,90,0,-90
2924,0,0,15,0,-15
2925,0,0,11,0,-11
2926,0,0,70,0,-70
2927,1,0,20,0,-20
2928,0,0,2,0,-2
2929,1,0,2,0,-2
2930,1,0,30,0,-30
2931,0,0,92,0,-92
2932,1,1,257,1465,1208
2933,1,1,350,2403,2053
2934,1,0,38,0,-38
2935,0,0,96,0,-96
2936,1,0,14,0,-14
2937,1,0,7,0,-7
2938,1,1,669,1458,789
2939,1,1,229,1343,1114
2940,0,0,0,0,0
2941,0,0,3,0,-3
2942,1,0,86,0,-86
2943,0,0,50,0,-50
2944,1,0,13,0,-13
2945,1,1,646,2013,1367
2946,0,0,2,0,-2
2947,0,0,9,0,-9
2948,0,0,2,0,-2
2949,0,0,37,0,-37
2950,1,0,60,0,-60
2951,1,0,50,0,-50
2952,1,0,33,0,-33
2953,0,0,2,0,-2
2954,1,1,122,1356,1234
2955,1,0,30,0,-30
2956,1,0,62,0,-62
2957,1,0,21,0,-21
2958,0,0,144,0,-144
2959,0,0,54,0,-54
2960,0,0,111,0,-111
2961,0,0,97,0,-97
2962,1,0,70,0,-70
2963,1,0,21,0,-21
2964,1,1,1087,1287,200
2965,1,0,17,0,-17
2966,1,1,57,3408,3351
2967,1,1,518,1905,1387
2968,0,0,39,0,-39
2969,1,1,292,1761,1469
2970,1,1,718,1457,739
2971,0,0,170,0,-170
2972,1,1,311,1270,959
2973,1,1,211,1257,1046
2974,0,0,72,0,-72
2975,1,0,43,0,-43
2976,1,0,84,0,-84
2977,1,1,205,1606,1401
2978,1,0,92,0,-92
2979,1,0,22,0,-22
2980,1,0,47,0,-47
2981,0,0,170,0,-170
2982,0,0,29,0,-29
2983,1,0,7,0,-7
2984,1,0,1,0,-1
2985,0,0,25,0,-25
2986,1,0,28,0,-28
2987,1,0,38,0,-38
2988,1,1,775,1424,649
2989,1,0,22,0,-22
2990,1,0,4,0,-4
2991,1,0,6,0,-6
2992,1,1,359,1529,1170
2993,1,0,9,0,-9
2994,0,0,0,0,0
2995,1,1,351,1286,935
2996,1,1,508,1272,764
2997,1,0,43,0,-43
2998,0,0,33,0,-33
2999,0,0,62,0,-62
3000,1,1,800,1273,473
3001,0,0,0,0,0
3002,0,0,3,0,-3
3003,1,1,660,1454,794
3004,1,0,126,0,-126
3005,0,0,183,0,-183
3006,1,0,106,0,-106
3007,1,1,591,1655,1064
3008,0,0,89,0,-89
3009,1,1,117,1889,1772
3010,0,0,56,0,-56
3011,0,0,63,0,-63
3012,0,0,91,0,-91
3013,1,1,653,1637,984
3014,0,0,155,0,-155
3015,1,1,840,1275,435
3016,0,0,43,0,-43
3017,0,0,72,0,-72
3018,0,0,72,0,-72
3019,0,0,67,0,-67
3020,0,0,104,0,-104
3021,1,0,94,0,-94
3022,0,0,108,0,-108
3023,1,0,101,0,-101
3024,1,0,13,0,-13
3025,1,1,204,1561,1357
3026,1,1,139,1777,1638
3027,1,1,406,1388,982
3028,0,0,10,0,-10
3029,0,0,91,0,-91
3030,1,0,22,0,-22
3031,0,0,5,0,-5
3032,0,0,66,0,-66
3033,0,0,15,0,-15
3034,1,0,7,0,-7
3035,0,0,22,0,-22
3036,1,1,734,1559,825
3037,1,0,28,0,-28
3038,1,1,685,1313,628
3039,1,0,89,0,-89
3040,0,0,7,0,-7
3041,1,1,534,1269,735
3042,0,0,77,0,-77
3043,0,0,33,0,-33
3044,1,1,497,1307,810
3045,0,0,98,0,-98
3046,1,1,145,1286,1141
3047,0,0,11,0,-11
3048,1,0,79,0,-79
3049,0,0,68,0,-68
3050,0,0,229,0,-229
3051,0,0,38,0,-38
3052,1,0,60,0,-60
3053,0,0,49,0,-49
3054,0,0,54,0,-54
3055,1,0,46,0,-46
3056,1,0,7,0,-7
3057,0,0,39,0,-39
3058,1,0,1,0,-1
3059,0,0,8,0,-8
3060,1,1,320,1564,1244
3061,0,0,47,0,-47
3062,1,0,58,0,-58
3063,1,0,9,0,-9
3064,1,1,127,1277,1150
3065,1,1,39,1232,1193
3066,0,0,137,0,-137
3067,1,0,38,0,-38
3068,0,0,19,0,-19
3069,1,1,394,1336,942
3070,1,1,341,1803,1462
3071,1,1,775,1242,467
3072,0,0,50,0,-50
3073,0,0,66,0,-66
3074,0,0,12,0,-12
3075,1,0,53,0,-53
3076,1,1,286,3244,2958
3077,0,0,75,0,-75
3078,0,0,40,0,-40
3079,1,1,111,1394,1283
3080,0,0,110,0,-110
3081,1,1,245,1525,1280
3082,1,0,37,0,-37
3083,0,0,93,0,-93
3084,1,0,45,0,-45
3085,0,0,30,0,-30
3086,1,0,78,0,-78
3087,1,1,544,1655,1111
3088,0,0,13,0,-13
3089,0,0,8,0,-8
3090,0,0,7,0,-7
3091,0,0,8,0,-8
3092,1,0,48,0,-48
3093,0,0,45,0,-45
3094,1,1,519,1215,696
3095,0,0,58,0,-58
3096,1,1,236,2235,1999
3097,1,0,94,0,-94
3098,1,0,13,0,-13
3099,1,1,93,1286,1193
3100,0,0,47,0,-47
3101,0,0,54,0,-54
3102,1,0,17,0,-17
3103,0,0,25,0,-25
3104,1,1,82,1359,1277
3105,1,1,48,1606,1558
3106,1,1,21,1482,1461
3107,1,0,94,0,-94
3108,1,0,15,0,-15
3109,0,0,179,0,-179
3110,1,0,9,0,-9
3111,0,0,52,0,-52
3112,1,1,81,2507,2426
3113,1,1,308,1418,1110
3114,1,0,134,0,-134
3115,1,1,1667,1319,-348
3116,1,1,560,1409,849
3117,1,0,116,0,-116
3118,0,0,85,0,-85
3119,1,0,25,0,-25
3120,1,1,486,1251,765
3121,1,0,25,0,-25
3122,0,0,1,0,-1
3123,1,1,630,1212,582
3124,1,0,29,0,-29
3125,1,1,257,1214,957
3126,1,0,74,0,-74
3127,1,0,1,0,-1
3128,1,1,589,1355,766
3129,0,0,6,0,-6
3130,1,1,1116,1629,513
3131,1,1,855,1844,989
3132,1,1,752,1416,664
3133,1,0,7,0,-7
3134,0,0,11,0,-11
3135,1,0,15,0,-15
3136,0,0,6,0,-6
3137,1,0,166,0,-166
3138,1,0,3,0,-3
3139,1,1,117,1214,1097
3140,0,0,63,0,-63
3141,0,0,28,0,-28
3142,0,0,109,0,-109
3143,0,0,29,0,-29
3144,0,0,21,0,-21
3145,0,0,35,0,-35
3146,1,1,1711,2981,1270
3147,0,0,138,0,-138
3148,0,0,81,0,-81
3149,0,0,7,0,-7
3150,1,1,524,1259,735
3151,1,0,13,0,-13
3152,0,0,33,0,-33
3153,1,0,52,0,-52
3154,0,0,66,0,-66
3155,0,0,233,0,-233
3156,0,0,31,0,-31
3157,1,0,55,0,-55
3158,1,0,18,0,-18
3159,1,1,557,1778,1221
3160,1,0,22,0,-22
3161,1,0,34,0,-34
3162,1,1,126,1231,1105
3163,1,1,688,1672,984
3164,1,0,55,0,-55
3165,0,0,34,0,-34
3166,0,0,101,0,-101
3167,0,0,24,0,-24
3168,1,1,588,3217,2629
3169,0,0,28,0,-28
3170,0,0,95,0,-95
3171,0,0,18,0,-18
3172,1,1,341,1767,1426
3173,1,0,73,0,-73
3174,1,1,149,1456,1307
3175,0,0,21,0,-21
3176,0,0,90,0,-90
3177,1,0,73,0,-73
3178,1,0,15,0,-15
3179,1,1,137,3506,3369
3180,0,0,63,0,-63
3181,0,0,43,0,-43
3182,0,0,16,0,-16
3183,0,0,42,0,-42
3184,1,0,61,0,-61
3185,0,0,12,0,-12
3186,1,0,23,0,-23
3187,0,0,0,0,0
3188,1,0,47,0,-47
3189,0,0,46,0,-46
3190,1,1,243,1251,1008
3191,1,1,5067,1566,-3501
3192,1,1,1035,1226,191
3193,1,0,120,0,-120
3194,1,1,363,1208,845
3195,1,1,1171,1412,241
3196,1,1,372,2023,1651
3197,1,0,25,0,-25
3198,1,1,47,3748,3701
3199,1,0,8,0,-8
3200,0,0,41,0,-41
3201,0,0,116,0,-116
3202,1,0,19,0,-19
3203,1,0,88,0,-88
3204,1,0,85,0,-85
3205,0,0,38,0,-38
3206,0,0,26,0,-26
3207,0,0,13,0,-13
3208,0,0,4,0,-4
3209,1,1,609,1946,1337
3210,1,0,1,0,-1
3211,0,0,16,0,-16
3212,1,0,20,0,-20
3213,1,0,31,0,-31
3214,1,0,147,0,-147
3215,1,1,538,1553,1015
3216,1,1,253,1300,1047
3217,1,0,9,0,-9
3218,1,1,318,1530,1212
3219,0,0,24,0,-24
3220,1,0,4,0,-4
3221,1,1,152,1296,1144
3222,0,0,20,0,-20
3223,0,0,32,0,-32
3224,1,0,19,0,-19
3225,0,0,47,0,-47
3226,0,0,23,0,-23
3227,1,0,80,0,-80
3228,1,0,1,0,-1
3229,0,0,18,0,-18
3230,1,1,175,1251,1076
3231,0,0,8,0,-8
3232,1,0,44,0,-44
3233,0,0,48,0,-48
3234,1,0,9,0,-9
3235,0,0,19,0,-19
3236,0,0,40,0,-40
3237,1,0,65,0,-65
3238,1,1,1514,1622,108
3239,1,0,36,0,-36
3240,0,0,178,0,-178
3241,0,0,79,0,-79
3242,1,0,41,0,-41
3243,1,1,37,1341,1304
3244,1,1,106,1224,1118
3245,0,0,79,0,-79
3246,1,0,72,0,-72
3247,1,1,1321,1560,239
3248,1,1,1051,1341,290
3249,1,0,282,0,-282
3250,1,0,48,0,-48
3251,1,1,28,1400,1372
3252,1,1,333,2432,2099
3253,1,1,254,1778,1524
3254,1,1,328,2585,2257
3255,1,1,164,1556,1392
3256,1,0,95,0,-95
3257,1,1,138,1288,1150
3258,1,1,171,1827,1656
3259,1,1,391,2292,1901
3260,0,0,81,0,-81
3261,0,0,7,0,-7
3262,0,0,46,0,-46
3263,0,0,96,0,-96
3264,1,0,1,0,-1
3265,1,1,839,1212,373
3266,1,0,65,0,-65
3267,0,0,22,0,-22
3268,0,0,26,0,-26
3269,0,0,31,0,-31
3270,0,0,20,0,-20
3271,1,1,301,1386,1085
3272,1,0,9,0,-9
3273,1,1,392,1262,870
3274,1,0,9,0,-9
3275,1,0,74,0,-74
3276,1,0,30,0,-30
3277,1,1,543,1224,681
3278,1,0,4,0,-4
3279,1,1,489,1974,1485
3280,1,1,579,1439,860
3281,0,0,51,0,-51
3282,0,0,177,0,-177
3283,1,1,293,1510,1217
3284,1,1,156,1210,1054
3285,1,0,33,0,-33
3286,1,0,7,0,-7
3287,1,1,438,2237,1799
3288,0,0,40,0,-40
3289,1,0,36,0,-36
3290,1,1,693,1297,604
3291,1,1,378,1335,957
3292,1,0,26,0,-26
3293,0,0,25,0,-25
3294,1,1,246,1397,1151
3295,1,1,571,1494,923
3296,0,0,45,0,-45
3297,0,0,16,0,-16
3298,1,0,78,0,-78
3299,1,0,11,0,-11
3300,0,0,3,0,-3
3301,1,1,395,1384,989
3302,1,1,99,1201,1102
3303,1,0,87,0,-87
3304,1,1,513,1557,1044
3305,1,1,75,1624,1549
3306,0,0,52,0,-52
3307,0,0,63,0,-63
3308,1,1,360,1920,1560
3309,1,1,381,1516,1135
3310,0,0,17,0,-17
3311,1,1,66,2197,2131
3312,1,0,98,0,-98
3313,1,1,236,1458,1222
3314,0,0,0,0,0
3315,1,0,1,0,-1
3316,1,1,393,1248,855
3317,1,0,78,0,-78
3318,0,0,24,0,-24
3319,1,1,1211,1309,98
3320,1,0,25,0,-25
3321,1,1,290,2329,2039
3322,0,0,3,0,-3
3323,0,0,19,0,-19
3324,1,1,135,2976,2841
3325,1,0,88,0,-88
3326,1,0,5,0,-5
3327,1,1,137,2108,1971
3328,0,0,2,0,-2
3329,0,0,73,0,-73
3330,1,1,213,1200,987
3331,0,0,1,0,-1
3332,0,0,11,0,-11
3333,0,0,51,0,-51
3334,0,0,109,0,-109
3335,0,0,32,0,-32
3336,1,1,81,1531,1450
3337,0,0,20,0,-20
3338,1,0,22,0,-22
3339,0,0,19,0,-19
3340,1,1,117,1248,1131
3341,1,1,459,2005,1546
3342,1,0,158,0,-158
3343,0,0,178,0,-178
3344,0,0,13,0,-13
3345,0,0,8,0,-8
3346,0,0,32,0,-32
3347,1,0,20,0,-20
3348,0,0,160,0,-160
3349,0,0,66,0,-66
3350,1,1,94,1629,1535
3351,1,1,355,1708,1353
3352,0,0,41,0,-41
3353,1,1,570,1203,633
3354,0,0,86,0,-86
3355,1,1,2367,1760,-607
3356,1,1,109,1341,1232
3357,1,1,354,1392,1038
3358,0,0,36,0,-36
3359,1,1,292,2653,2361
3360,0,0,81,0,-81
3361,1,1,72,1220,1148
3362,0,0,26,0,-26
3363,1,1,575,1403,828
3364,1,0,29,0,-29
3365,0,0,57,0,-57
3366,0,0,47,0,-47
3367,1,0,36,0,-36
3368,1,1,401,1440,1039
3369,1,1,486,1610,1124
3370,1,1,2199,1563,-636
3371,1,1,1108,2676,1568
3372,0,0,8,0,-8
3373,1,0,197,0,-197
3374,1,1,386,2135,1749
3375,0,0,83,0,-83
3376,1,0,7,0,-7
3377,1,0,30,0,-30
3378,0,0,68,0,-68
3379,0,0,68,0,-68
3380,1,1,223,1670,1447
3381,1,1,796,1240,444
3382,0,0,136,0,-136
3383,1,0,55,0,-55
3384,1,1,368,1454,1086
3385,1,1,60,1339,1279
3386,1,1,305,1262,957
3387,0,0,17,0,-17
3388,0,0,80,0,-80
3389,1,0,33,0,-33
3390,0,0,87,0,-87
3391,1,0,6,0,-6
3392,0,0,158,0,-158
3393,1,1,326,1739,1413
3394,0,0,15,0,-15
3395,1,1,995,1918,923
3396,0,0,9,0,-9
3397,1,1,1777,1433,-344
3398,1,1,492,1296,804
3399,1,0,30,0,-30
3400,1,1,371,4878,4507
3401,1,1,18,1443,1425
3402,1,1,619,1288,669
3403,1,0,10,0,-10
3404,0,0,7,0,-7
3405,0,0,34,0,-34
3406,1,1,558,1224,666
3407,1,0,26,0,-26
3408,1,1,65,1875,1810
3409,1,1,498,1775,1277
3410,1,0,4,0,-4
3411,1,1,275,1465,1190
3412,1,0,55,0,-55
3413,1,1,252,1287,1035
3414,0,0,54,0,-54
3415,1,1,120,1225,1105
3416,0,0,22,0,-22
3417,1,1,519,1257,738
3418,1,1,603,1426,823
3419,1,1,737,1404,667
3420,0,0,15,0,-15
3421,0,0,43,0,-43
3422,0,0,57,0,-57
3423,1,1,78,1835,1757
3424,1,1,1033,1740,707
3425,1,0,40,0,-40
3426,0,0,19,0,-19
3427,1,1,84,1357,1273
3428,0,0,19,0,-19
3429,0,0,9,0,-9
3430,1,0,176,0,-176
3431,0,0,55,0,-55
3432,0,0,120,0,-120
3433,1,0,109,0,-109
3434,0,0,42,0,-42
3435,1,0,36,0,-36
3436,0,0,7,0,-7
3437,1,1,281,1285,1004
3438,0,0,6,0,-6
3439,1,1,530,1529,999
3440,0,0,134,0,-134
3441,1,1,156,1528,1372
3442,0,0,35,0,-35
3443,1,0,38,0,-38
3444,0,0,85,0,-85
3445,0,0,37,0,-37
3446,1,1,541,1215,674
3447,1,1,347,1840,1493
3448,0,0,8,0,-8
3449,1,1,101,1350,1249
3450,0,0,37,0,-37
3451,0,0,5,0,-5
3452,0,0,103,0,-103
3453,1,0,28,0,-28
3454,1,1,294,1311,1017
3455,0,0,76,0,-76
3456,1,1,373,1257,884
3457,1,1,765,1251,486
3458,1,1,151,1508,1357
3459,0,0,4,0,-4
3460,0,0,38,0,-38
3461,1,0,41,0,-41
3462,1,1,657,1462,805
3463,1,1,789,1464,675
3464,1,0,38,0,-38
3465,1,1,370,1582,1212
3466,0,0,18,0,-18
3467,1,0,83,0,-83
3468,1,0,16,0,-16
3469,1,1,575,1274,699
3470,0,0,5,0,-5
3471,1,1,843,1231,388
3472,1,0,19,0,-19
3473,0,0,105,0,-105
3474,0,0,82,0,-82
3475,1,0,60,0,-60
3476,1,1,1560,1528,-32
3477,0,0,16,0,-16
3478,1,0,33,0,-33
3479,1,1,431,1543,1112
3480,0,0,3,0,-3
3481,0,0,5,0,-5
3482,1,0,1,0,-1
3483,0,0,53,0,-53
3484,1,1,83,1472,1389
3485,0,0,4,0,-4
3486,0,0,98,0,-98
3487,1,1,813,1309,496
3488,0,0,39,0,-39
3489,1,1,222,1501,1279
3490,0,0,20,0,-20
3491,1,1,382,1601,1219
3492,1,1,987,1260,273
3493,1,1,415,1669,1254
3494,1,1,638,1351,713
3495,1,0,12,0,-12
3496,0,0,3,0,-3
3497,1,0,0,0,0
3498,1,1,382,1517,1135
3499,1,0,74,0,-74
3500,1,1,198,1659,1461
3501,0,0,54,0,-54
3502,0,0,43,0,-43
3503,0,0,41,0,-41
3504,0,0,20,0,-20
3505,0,0,89,0,-89
3506,0,0,34,0,-34
3507,1,1,694,1465,771
3508,1,1,1005,1753,748
3509,1,1,246,1578,1332
3510,0,0,60,0,-60
3511,1,1,1327,1259,-68
3512,0,0,21,0,-21
3513,1,0,2,0,-2
3514,0,0,20,0,-20
3515,0,0,11,0,-11
3516,1,0,77,0,-77
3517,0,0,102,0,-102
3518,1,1,289,1242,953
3519,1,0,73,0,-73
3520,1,1,375,1555,1180
3521,1,0,24,0,-24
3522,1,0,31,0,-31
3523,1,0,194,0,-194
3524,1,0,174,0,-174
3525,0,0,12,0,-12
3526,1,1,210,1319,1109
3527,1,1,346,1259,913
3528,1,1,50,1538,1488
3529,1,1,1080,1461,381
3530,0,0,5,0,-5
3531,0,0,32,0,-32
3532,0,0,31,0,-31
3533,1,1,137,1215,1078
3534,0,0,6,0,-6
3535,1,1,448,1433,985
3536,1,0,14,0,-14
3537,1,1,35,1426,1391
3538,1,1,1135,1210,75
3539,1,1,1940,1748,-192
3540,1,1,102,1204,1102
3541,0,0,31,0,-31
3542,0,0,63,0,-63
3543,1,1,426,1267,841
3544,1,1,270,1792,1522
3545,1,1,250,1529,1279
3546,1,1,411,1223,812
3547,1,1,134,1810,1676
3548,1,1,317,1246,929
3549,1,0,106,0,-106
3550,1,0,56,0,-56
3551,1,0,62,0,-62
3552,1,0,118,0,-118
3553,0,0,15,0,-15
3554,1,1,845,2272,1427
3555,1,0,30,0,-30
3556,1,1,358,1780,1422
3557,1,0,63,0,-63
3558,0,0,9,0,-9
3559,0,0,31,0,-31
3560,0,0,58,0,-58
3561,1,0,13,0,-13
3562,1,0,102,0,-102
3563,0,0,30,0,-30
3564,1,0,24,0,-24
3565,0,0,47,0,-47
3566,0,0,78,0,-78
3567,1,1,474,1215,741
3568,0,0,36,0,-36
3569,1,1,676,1534,858
3570,1,0,224,0,-224
3571,0,0,26,0,-26
3572,1,0,21,0,-21
3573,0,0,40,0,-40
3574,1,1,15,1754,1739
3575,1,0,76,0,-76
3576,1,0,4,0,-4
3577,0,0,58,0,-58
3578,1,1,886,1401,515
3579,1,1,152,1267,1115
3580,0,0,61,0,-61
3581,1,0,92,0,-92
3582,0,0,39,0,-39
3583,1,0,96,0,-96
3584,1,0,83,0,-83
3585,1,1,228,1527,1299
3586,0,0,32,0,-32
3587,0,0,50,0,-50
3588,1,0,65,0,-65
3589,0,0,50,0,-50
3590,1,1,213,1323,1110
3591,1,1,1757,1286,-471
3592,0,0,7,0,-7
3593,0,0,23,0,-23
3594,1,0,4,0,-4
3595,0,0,220,0,-220
3596,1,0,15,0,-15
3597,1,1,72,1678,1606
3598,0,0,45,0,-45
3599,0,0,1,0,-1
3600,0,0,21,0,-21
3601,0,0,43,0,-43
3602,0,0,12,0,-12
3603,0,0,37,0,-37
3604,1,1,317,1441,1124
3605,0,0,32,0,-32
3606,1,1,605,1272,667
3607,1,1,228,1318,1090
3608,1,0,56,0,-56
3609,1,1,645,2082,1437
3610,1,0,5,0,-5
3611,1,0,50,0,-50
3612,1,1,245,2666,2421
3613,1,1,487,1299,812
3614,0,0,29,0,-29
3615,1,0,27,0,-27
3616,0,0,74,0,-74
3617,1,0,21,0,-21
3618,1,0,41,0,-41
3619,0,0,114,0,-114
3620,1,0,142,0,-142
3621,0,0,8,0,-8
3622,1,1,412,1515,1103
3623,0,0,104,0,-104
3624,1,0,48,0,-48
3625,1,0,82,0,-82
3626,0,0,54,0,-54
3627,1,0,5,0,-5
3628,0,0,7,0,-7
3629,0,0,20,0,-20
3630,1,0,4,0,-4
3631,1,0,35,0,-35
3632,1,1,87,1969,1882
3633,0,0,12,0,-12
3634,0,0,19,0,-19
3635,1,1,489,2066,1577
3636,0,0,142,0,-142
3637,1,0,151,0,-151
3638,1,0,16,0,-16
3639,0,0,86,0,-86
3640,1,1,186,2319,2133
3641,0,0,1,0,-1
3642,1,0,11,0,-11
3643,1,0,70,0,-70
3644,1,1,230,1288,1058
3645,0,0,10,0,-10
3646,1,0,11,0,-11
3647,1,0,16,0,-16
3648,1,1,666,1302,636
3649,0,0,127,0,-127
3650,0,0,45,0,-45
3651,1,0,39,0,-39
3652,1,1,569,1255,686
3653,1,0,4,0,-4
3654,1,0,63,0,-63
3655,1,0,74,0,-74
3656,0,0,58,0,-58
3657,0,0,52,0,-52
3658,0,0,24,0,-24
3659,1,1,1339,1579,240
3660,1,0,3,0,-3
3661,0,0,13,0,-13
3662,1,0,14,0,-14
3663,1,0,84,0,-84
3664,0,0,6,0,-6
3665,1,1,193,1273,1080
3666,0,0,150,0,-150
3667,1,1,256,1334,1078
3668,0,0,25,0,-25
3669,1,1,253,2620,2367
3670,1,1,740,1753,1013
3671,1,0,13,0,-13
3672,0,0,22,0,-22
3673,0,0,87,0,-87
3674,0,0,45,0,-45
3675,0,0,16,0,-16
3676,1,0,9,0,-9
3677,1,1,850,1614,764
3678,0,0,49,0,-49
3679,1,1,172,1532,1360
3680,0,0,22,0,-22
3681,1,0,72,0,-72
3682,1,0,71,0,-71
3683,1,1,68,1230,1162
3684,0,0,14,0,-14
3685,0,0,11,0,-11
3686,1,0,58,0,-58
3687,0,0,48,0,-48
3688,0,0,21,0,-21
3689,0,0,0,0,0
3690,1,1,403,1490,1087
3691,0,0,7,0,-7
3692,0,0,33,0,-33
3693,1,1,251,1671,1420
3694,1,0,55,0,-55
3695,1,0,32,0,-32
3696,1,0,5,0,-5
3697,1,0,1,0,-1
3698,0,0,14,0,-14
3699,1,1,585,1800,1215
3700,0,0,2,0,-2
3701,0,0,71,0,-71
3702,1,0,0,0,0
3703,0,0,85,0,-85
3704,0,0,11,0,-11
3705,1,0,13,0,-13
3706,1,1,212,2457,2245
3707,1,0,33,0,-33
3708,0,0,68,0,-68
3709,1,0,12,0,-12
3710,0,0,6,0,-6
3711,0,0,11,0,-11
3712,0,0,1,0,-1
3713,0,0,92,0,-92
3714,0,0,2,0,-2
3715,1,1,247,1614,1367
3716,1,0,56,0,-56
3717,0,0,56,0,-56
3718,1,1,925,1200,275
3719,1,1,88,1273,1185
3720,1,1,481,1294,813
3721,1,1,306,1415,1109
3722,0,0,42,0,-42
3723,0,0,22,0,-22
3724,1,1,142,1548,1406
3725,1,0,7,0,-7
3726,0,0,146,0,-146
3727,0,0,14,0,-14
3728,1,1,559,1956,1397
3729,0,0,18,0,-18
3730,1,0,15,0,-15
3731,1,0,62,0,-62
3732,1,1,550,1372,822
3733,0,0,84,0,-84
3734,1,1,49,1780,1731
3735,0,0,11,0,-11
3736,0,0,73,0,-73
3737,1,0,22,0,-22
3738,1,0,7,0,-7
3739,0,0,27,0,-27
3740,0,0,7,0,-7
3741,1,0,3,0,-3
3742,1,1,161,1225,1064
3743,1,1,376,1716,1340
3744,0,0,34,0,-34
3745,0,0,75,0,-75
3746,1,0,145,0,-145
3747,1,0,17,0,-17
3748,1,1,1388,2027,639
3749,1,1,83,1204,1121
3750,1,1,504,1230,726
3751,1,1,613,1434,821
3752,1,0,55,0,-55
3753,0,0,21,0,-21
3754,1,0,6,0,-6
3755,0,0,14,0,-14
3756,1,1,416,1310,894
3757,0,0,56,0,-56
3758,0,0,1,0,-1
3759,1,1,1247,1232,-15
3760,0,0,25,0,-25
3761,1,1,405,3132,2727
3762,0,0,20,0,-20
3763,1,0,261,0,-261
3764,0,0,58,0,-58
3765,1,0,1,0,-1
3766,0,0,26,0,-26
3767,0,0,39,0,-39
3768,0,0,118,0,-118
3769,1,1,676,2753,2077
3770,1,1,344,1823,1479
3771,0,0,29,0,-29
3772,1,0,42,0,-42
3773,0,0,5,0,-5
3774,1,0,22,0,-22
3775,1,0,36,0,-36
3776,0,0,87,0,-87
3777,1,0,10,0,-10
3778,0,0,13,0,-13
3779,0,0,47,0,-47
3780,0,0,16,0,-16
3781,1,1,604,1531,927
3782,1,1,1784,1579,-205
3783,0,0,81,0,-81
3784,0,0,0,0,0
3785,0,0,30,0,-30
3786,0,0,109,0,-109
3787,1,0,24,0,-24
3788,1,0,37,0,-37
3789,0,0,12,0,-12
3790,1,1,979,1214,235
3791,0,0,51,0,-51
3792,1,0,11,0,-11
3793,1,1,452,1355,903
3794,0,0,51,0,-51
3795,0,0,70,0,-70
3796,1,0,4,0,-4
3797,1,1,20,1365,1345
3798,0,0,110,0,-110
3799,1,0,17,0,-17
3800,0,0,20,0,-20
3801,1,1,865,2277,1412
3802,0,0,13,0,-13
3803,1,0,2,0,-2
3804,1,0,28,0,-28
3805,1,1,469,2409,1940
3806,1,1,91,1224,1133
3807,0,0,125,0,-125
3808,0,0,42,0,-42
3809,1,0,3,0,-3
3810,1,0,2,0,-2
3811,1,1,395,1312,917
3812,1,0,144,0,-144
3813,1,1,232,1324,1092
3814,1,0,9,0,-9
3815,0,0,19,0,-19
3816,1,1,201,1356,1155
3817,1,1,175,1727,1552
3818,1,0,2,0,-2
3819,0,0,34,0,-34
3820,1,0,41,0,-41
3821,0,0,97,0,-97
3822,1,0,28,0,-28
3823,0,0,9,0,-9
3824,0,0,107,0,-107
3825,1,1,184,4215,4031
3826,0,0,4,0,-4
3827,1,0,49,0,-49
3828,1,0,63,0,-63
3829,0,0,63,0,-63
3830,1,1,384,1353,969
3831,1,1,131,1642,1511
3832,1,1,2171,1262,-909
3833,1,0,16,0,-16
3834,1,1,1832,1873,41
3835,0,0,25,0,-25
3836,0,0,38,0,-38
3837,1,1,591,1336,745
3838,1,1,255,1222,967
3839,0,0,31,0,-31
3840,1,0,44,0,-44
3841,0,0,121,0,-121
3842,0,0,104,0,-104
3843,1,1,230,2274,2044
3844,1,1,491,1556,1065
3845,1,0,7,0,-7
3846,1,0,16,0,-16
3847,1,1,197,1401,1204
3848,1,0,7,0,-7
3849,0,0,14,0,-14
3850,0,0,5,0,-5
3851,1,0,27,0,-27
3852,0,0,24,0,-24
3853,1,0,28,0,-28
3854,1,0,145,0,-145
3855,1,1,241,1217,976
3856,1,0,85,0,-85
3857,0,0,4,0,-4
3858,0,0,15,0,-15
3859,0,0,73,0,-73
3860,0,0,6,0,-6
3861,0,0,1,0,-1
3862,0,0,4,0,-4
3863,0,0,88,0,-88
3864,1,1,319,1675,1356
3865,1,0,25,0,-25
3866,0,0,210,0,-210
3867,1,0,48,0,-48
3868,0,0,66,0,-66
3869,0,0,7,0,-7
3870,1,1,1067,1409,342
3871,1,0,9,0,-9
3872,1,0,92,0,-92
3873,0,0,3,0,-3
3874,1,0,20,0,-20
3875,1,1,45,1272,1227
3876,1,1,548,1444,896
3877,0,0,28,0,-28
3878,1,1,628,1332,704
3879,1,0,52,0,-52
3880,1,0,89,0,-89
3881,1,0,44,0,-44
3882,1,1,1512,1263,-249
3883,1,1,31,1308,1277
3884,1,1,609,1616,1007
3885,1,0,35,0,-35
3886,1,0,26,0,-26
3887,1,0,73,0,-73
3888,1,0,61,0,-61
3889,1,1,205,1316,1111
3890,1,0,40,0,-40
3891,1,0,12,0,-12
3892,1,1,67,1324,1257
3893,1,1,122,1328,1206
3894,0,0,23,0,-23
3895,1,1,171,4429,4258
3896,1,1,807,2329,1522
3897,1,1,512,1314,802
3898,0,0,5,0,-5
3899,1,0,94,0,-94
3900,0,0,107,0,-107
3901,1,0,18,0,-18
3902,1,1,265,2545,2280
3903,1,0,42,0,-42
3904,1,1,177,1472,1295
3905,0,0,136,0,-136
3906,1,1,153,1277,1124
3907,0,0,22,0,-22
3908,1,0,175,0,-175
3909,1,0,252,0,-252
3910,0,0,15,0,-15
3911,1,1,58,1402,1344
3912,1,0,0,0,0
3913,0,0,111,0,-111
3914,1,1,889,1235,346
3915,0,0,47,0,-47
3916,1,0,24,0,-24
3917,1,0,12,0,-12
3918,1,1,653,2221,1568
3919,0,0,10,0,-10
3920,1,0,10,0,-10
3921,0,0,76,0,-76
3922,1,0,126,0,-126
3923,1,0,65,0,-65
3924,1,0,14,0,-14
3925,1,1,96,1612,1516
3926,1,0,15,0,-15
3927,0,0,45,0,-45
3928,1,1,132,1289,1157
3929,1,1,2308,1529,-779
3930,1,0,22,0,-22
3931,1,1,104,3135,3031
3932,1,1,1151,1347,196
3933,1,0,220,0,-220
3934,1,1,245,1558,1313
3935,0,0,28,0,-28
3936,1,1,345,1691,1346
3937,1,0,111,0,-111
3938,1,0,82,0,-82
3939,1,1,389,1353,964
3940,0,0,11,0,-11
3941,0,0,43,0,-43
3942,0,0,47,0,-47
3943,0,0,11,0,-11
3944,1,0,85,0,-85
3945,0,0,97,0,-97
3946,0,0,41,0,-41
3947,1,1,33,1213,1180
3948,1,1,764,1946,1182
3949,0,0,36,0,-36
3950,1,1,600,1201,601
3951,1,0,123,0,-123
3952,1,1,375,1259,884
3953,0,0,29,0,-29
3954,1,0,20,0,-20
3955,0,0,22,0,-22
3956,1,1,87,1366,1279
3957,0,0,24,0,-24
3958,1,1,564,1551,987
3959,1,1,198,1551,1353
3960,1,0,55,0,-55
3961,1,0,18,0,-18
3962,1,0,66,0,-66
3963,0,0,14,0,-14
3964,0,0,249,0,-249
3965,1,0,13,0,-13
3966,1,0,14,0,-14
3967,1,0,15,0,-15
3968,1,1,459,1642,1183
3969,0,0,1,0,-1
3970,0,0,47,0,-47
3971,0,0,141,0,-141
3972,1,1,185,3783,3598
3973,1,1,1239,1201,-38
3974,1,1,19,1205,1186
3975,1,0,51,0,-51
3976,0,0,123,0,-123
3977,1,0,1,0,-1
3978,1,1,323,1521,1198
3979,0,0,53,0,-53
3980,1,0,0,0,0
3981,0,0,16,0,-16
3982,0,0,9,0,-9
3983,1,1,183,1361,1178
3984,1,0,0,0,0
3985,0,0,5,0,-5
3986,1,1,502,1270,768
3987,1,0,6,0,-6
3988,1,1,334,1346,1012
3989,0,0,216,0,-216
3990,1,1,57,1408,1351
3991,1,0,144,0,-144
3992,0,0,68,0,-68
3993,1,0,272,0,-272
3994,1,0,30,0,-30
3995,0,0,41,0,-41
3996,1,1,121,1455,1334
3997,0,0,157,0,-157
3998,1,1,389,1538,1149
3999,0,0,69,0,-69
4000,1,0,8,0,-8
4001,1,1,227,1859,1632
4002,1,0,54,0,-54
4003,0,0,76,0,-76
4004,1,0,67,0,-67
4005,1,0,64,0,-64
4006,1,0,53,0,-53
4007,1,1,1728,1390,-338
4008,1,1,268,1576,1308
4009,1,0,54,0,-54
4010,1,1,2063,2022,-41
4011,0,0,46,0,-46
4012,1,0,23,0,-23
4013,1,0,9,0,-9
4014,0,0,8,0,-8
4015,1,1,763,1446,683
4016,1,0,138,0,-138
4017,1,0,112,0,-112
4018,0,0,11,0,-11
4019,1,0,37,0,-37
4020,1,1,38,1369,1331
4021,1,0,36,0,-36
4022,0,0,8,0,-8
4023,1,1,159,1746,1587
4024,1,1,263,1289,1026
4025,0,0,11,0,-11
4026,1,1,489,1701,1212
4027,1,1,123,1308,1185
4028,1,0,152,0,-152
4029,1,0,25,0,-25
4030,0,0,42,0,-42
4031,1,1,548,1533,985
4032,0,0,43,0,-43
4033,0,0,124,0,-124
4034,0,0,25,0,-25
4035,0,0,19,0,-19
4036,1,0,27,0,-27
4037,0,0,6,0,-6
4038,1,1,999,1500,501
4039,0,0,3,0,-3
4040,0,0,27,0,-27
4041,1,1,1442,1672,230
4042,0,0,161,0,-161
4043,0,0,9,0,-9
4044,1,0,27,0,-27
4045,1,1,2683,1335,-1348
4046,0,0,85,0,-85
4047,0,0,28,0,-28
4048,1,0,72,0,-72
4049,1,0,45,0,-45
4050,0,0,36,0,-36
4051,0,0,58,0,-58
4052,1,1,534,1204,670
4053,1,1,245,1449,1204
4054,1,0,41,0,-41
4055,1,1,147,1255,1108
4056,0,0,10,0,-10
4057,1,0,58,0,-58
4058,0,0,8,0,-8
4059,1,0,71,0,-71
4060,1,1,313,1200,887
4061,1,1,42,1423,1381
4062,0,0,30,0,-30
4063,0,0,2,0,-2
4064,0,0,114,0,-114
4065,1,0,58,0,-58
4066,0,0,48,0,-48
4067,1,1,346,1216,870
4068,1,0,63,0,-63
4069,1,0,67,0,-67
4070,0,0,117,0,-117
4071,0,0,5,0,-5
4072,0,0,49,0,-49
4073,0,0,73,0,-73
4074,1,1,305,1260,955
4075,1,1,164,1316,1152
4076,1,1,186,1610,1424
4077,0,0,143,0,-143
4078,1,0,6,0,-6
4079,0,0,37,0,-37
4080,0,0,29,0,-29
4081,0,0,25,0,-25
4082,0,0,49,0,-49
4083,1,1,68,1848,1780
4084,1,1,379,1929,1550
4085,0,0,63,0,-63
4086,1,1,948,1204,256
4087,0,0,124,0,-124
4088,0,0,22,0,-22
4089,1,1,402,1201,799
4090,1,1,1089,3619,2530
4091,1,1,64,1718,1654
4092,1,1,658,2003,1345
4093,1,0,90,0,-90
4094,1,0,5,0,-5
4095,0,0,30,0,-30
4096,0,0,47,0,-47
4097,1,1,2998,1725,-1273
4098,1,1,480,1368,888
4099,1,1,346,2135,1789
4100,0,0,6,0,-6
4101,1,1,1369,1844,475
4102,0,0,101,0,-101
4103,1,0,104,0,-104
4104,1,0,59,0,-59
4105,0,0,33,0,-33
4106,1,0,27,0,-27
4107,1,1,391,1258,867
4108,1,1,13,1219,1206
4109,1,1,781,1267,486
4110,1,0,0,0,0
4111,1,1,505,1395,890
4112,0,0,5,0,-5
4113,0,0,21,0,-21
4114,1,0,16,0,-16
4115,0,0,3,0,-3
4116,0,0,23,0,-23
4117,0,0,25,0,-25
4118,1,1,262,1349,1087
4119,1,1,358,1439,1081
4120,0,0,13,0,-13
4121,1,1,832,1554,722
4122,1,0,28,0,-28
4123,0,0,216,0,-216
4124,0,0,10,0,-10
4125,0,0,12,0,-12
4126,0,0,69,0,-69
4127,1,1,304,1317,1013
4128,1,0,1,0,-1
4129,0,0,10,0,-10
4130,1,0,105,0,-105
4131,0,0,10,0,-10
4132,1,0,38,0,-38
4133,0,0,84,0,-84
4134,1,0,4,0,-4
4135,0,0,5,0,-5
4136,0,0,41,0,-41
4137,0,0,114,0,-114
4138,1,1,1556,1236,-320
4139,0,0,31,0,-31
4140,0,0,13,0,-13
4141,1,0,88,0,-88
4142,0,0,83,0,-83
4143,1,1,463,1330,867
4144,1,1,480,1398,918
4145,0,0,199,0,-199
4146,1,0,20,0,-20
4147,0,0,16,0,-16
4148,1,0,9,0,-9
4149,1,1,1885,1249,-636
4150,0,0,123,0,-123
4151,0,0,5,0,-5
4152,0,0,31,0,-31
4153,1,1,552,1713,1161
4154,1,1,377,1296,919
4155,1,0,47,0,-47
4156,1,1,108,1208,1100
4157,0,0,27,0,-27
4158,0,0,83,0,-83
4159,1,1,1321,1233,-88
4160,1,0,236,0,-236
4161,0,0,68,0,-68
4162,0,0,54,0,-54
4163,1,1,236,1484,1248
4164,0,0,4,0,-4
4165,0,0,14,0,-14
4166,1,0,118,0,-118
4167,0,0,238,0,-238
4168,1,1,690,1450,760
4169,1,1,788,1576,788
4170,1,1,934,1204,270
4171,1,0,42,0,-42
4172,1,0,5,0,-5
4173,0,0,115,0,-115
4174,1,1,1106,1448,342
4175,1,0,40,0,-40
4176,1,1,775,1263,488
4177,1,1,660,1210,550
4178,1,0,6,0,-6
4179,1,0,87,0,-87
4180,0,0,39,0,-39
4181,1,0,64,0,-64
4182,1,1,105,1957,1852
4183,0,0,46,0,-46
4184,1,0,0,0,0
4185,1,0,120,0,-120
4186,0,0,63,0,-63
4187,0,0,2,0,-2
4188,1,0,17,0,-17
4189,1,1,151,1851,1700
4190,0,0,212,0,-212
4191,1,1,372,1227,855
4192,1,0,38,0,-38
4193,1,0,65,0,-65
4194,1,0,17,0,-17
4195,0,0,1,0,-1
4196,0,0,25,0,-25
4197,1,0,90,0,-90
4198,1,0,12,0,-12
4199,0,0,20,0,-20
4200,0,0,40,0,-40
4201,1,1,253,1250,997
4202,1,1,398,1248,850
4203,1,0,148,0,-148
4204,1,0,17,0,-17
4205,1,0,57,0,-57
4206,1,0,55,0,-55
4207,1,1,79,2354,2275
4208,0,0,5,0,-5
4209,1,0,17,0,-17
4210,1,1,2220,2366,146
4211,1,1,289,1451,1162
4212,0,0,15,0,-15
4213,1,1,180,2100,1920
4214,1,0,99,0,-99
4215,1,1,564,1550,986
4216,0,0,180,0,-180
4217,0,0,6,0,-6
4218,1,1,481,1791,1310
4219,0,0,67,0,-67
4220,1,0,146,0,-146
4221,1,0,1,0,-1
4222,1,0,23,0,-23
4223,0,0,23,0,-23
4224,1,1,547,1558,1011
4225,1,0,45,0,-45
4226,1,0,27,0,-27
4227,1,0,59,0,-59
4228,1,0,10,0,-10
4229,1,1,109,1682,1573
4230,1,0,43,0,-43
4231,1,1,255,1998,1743
4232,1,1,292,1860,1568
4233,1,1,271,1908,1637
4234,1,0,84,0,-84
4235,0,0,1,0,-1
4236,1,0,0,0,0
4237,0,0,96,0,-96
4238,1,0,64,0,-64
4239,1,0,69,0,-69
4240,1,1,354,1483,1129
4241,0,0,31,0,-31
4242,1,1,58,1288,1230
4243,0,0,39,0,-39
4244,0,0,53,0,-53
4245,0,0,4,0,-4
4246,1,1,75,1295,1220
4247,1,1,637,1571,934
4248,1,1,302,1252,950
4249,0,0,13,0,-13
4250,1,0,0,0,0
4251,1,1,1266,1366,100
4252,0,0,47,0,-47
4253,1,0,46,0,-46
4254,1,0,1,0,-1
4255,1,1,53,1511,1458
4256,1,0,47,0,-47
4257,1,0,8,0,-8
4258,0,0,6,0,-6
4259,1,1,213,1336,1123
4260,1,1,244,1479,1235
4261,1,1,409,1217,808
4262,1,0,25,0,-25
4263,1,0,17,0,-17
4264,0,0,142,0,-142
4265,1,1,2469,1520,-949
4266,1,1,993,1625,632
4267,1,1,469,2304,1835
4268,0,0,102,0,-102
4269,1,0,10,0,-10
4270,1,0,7,0,-7
4271,0,0,56,0,-56
4272,1,1,763,1314,551
4273,1,0,65,0,-65
4274,1,1,135,1344,1209
4275,0,0,7,0,-7
4276,1,0,18,0,-18
4277,1,1,701,1461,760
4278,1,1,169,1351,1182
4279,0,0,13,0,-13
4280,1,0,59,0,-59
4281,0,0,21,0,-21
4282,1,0,0,0,0
4283,0,0,14,0,-14
4284,0,0,40,0,-40
4285,0,0,16,0,-16
4286,0,0,20,0,-20
4287,1,0,113,0,-113
4288,1,1,266,1283,1017
4289,0,0,31,0,-31
4290,0,0,62,0,-62
4291,0,0,3,0,-3
4292,1,0,32,0,-32
4293,1,0,51,0,-51
4294,0,0,10,0,-10
4295,0,0,117,0,-117
4296,0,0,51,0,-51
4297,0,0,84,0,-84
4298,1,1,239,1335,1096
4299,1,1,316,2048,1732
4300,1,0,13,0,-13
4301,1,1,1879,1538,-341
4302,0,0,22,0,-22
4303,1,1,991,1615,624
4304,0,0,23,0,-23
4305,0,0,34,0,-34
4306,1,1,1767,1870,103
4307,1,1,117,1289,1172
4308,1,0,59,0,-59
4309,1,1,1313,1214,-99
4310,1,1,586,1492,906
4311,0,0,23,0,-23
4312,1,0,52,0,-52
4313,1,0,5,0,-5
4314,1,0,2,0,-2
4315,1,1,983,1438,455
4316,1,0,17,0,-17
4317,0,0,42,0,-42
4318,0,0,90,0,-90
4319,0,0,24,0,-24
4320,1,1,1026,2026,1000
4321,1,0,63,0,-63
4322,1,0,74,0,-74
4323,1,1,241,1841,1600
4324,1,0,0,0,0
4325,1,0,30,0,-30
4326,0,0,87,0,-87
4327,0,0,104,0,-104
4328,0,0,16,0,-16
4329,1,0,42,0,-42
4330,1,1,791,1609,818
4331,1,0,7,0,-7
4332,0,0,4,0,-4
4333,0,0,18,0,-18
4334,1,0,57,0,-57
4335,0,0,17,0,-17
4336,1,0,63,0,-63
4337,1,1,283,1565,1282
4338,0,0,13,0,-13
4339,1,1,12,1228,1216
4340,1,1,654,1225,571
4341,0,0,2,0,-2
4342,1,1,716,1445,729
4343,0,0,7,0,-7
4344,1,1,205,1514,1309
4345,0,0,18,0,-18
4346,0,0,17,0,-17
4347,1,0,153,0,-153
4348,0,0,29,0,-29
4349,1,0,84,0,-84
4350,0,0,40,0,-40
4351,1,0,66,0,-66
4352,1,0,45,0,-45
4353,1,0,17,0,-17
4354,1,1,62,1594,1532
4355,1,1,373,1260,887
4356,0,0,30,0,-30
4357,0,0,24,0,-24
4358,1,1,436,2153,1717
4359,1,1,491,1412,921
4360,1,0,5,0,-5
4361,0,0,44,0,-44
4362,0,0,9,0,-9
4363,0,0,37,0,-37
4364,1,1,849,1444,595
4365,0,0,24,0,-24
4366,0,0,50,0,-50
4367,1,1,94,1207,1113
4368,1,1,155,1231,1076
4369,1,1,249,1431,1182
4370,1,0,31,0,-31
4371,0,0,37,0,-37
4372,0,0,49,0,-49
4373,1,0,120,0,-120
4374,1,1,248,1531,1283
4375,1,1,626,1211,585
4376,0,0,53,0,-53
4377,1,1,330,1748,1418
4378,0,0,51,0,-51
4379,0,0,36,0,-36
4380,1,1,2027,1417,-610
4381,0,0,52,0,-52
4382,1,0,14,0,-14
4383,0,0,7,0,-7
4384,1,0,25,0,-25
4385,1,1,273,1444,1171
4386,1,1,728,2137,1409
4387,0,0,134,0,-134
4388,1,1,16,2007,1991
4389,1,1,67,1353,1286
4390,0,0,22,0,-22
4391,1,1,1437,1368,-69
4392,0,0,12,0,-12
4393,0,0,12,0,-12
4394,1,1,522,1344,822
4395,1,1,332,1858,1526
4396,0,0,13,0,-13
4397,0,0,10,0,-10
4398,0,0,31,0,-31
4399,1,0,89,0,-89
4400,1,1,131,1489,1358
4401,0,0,9,0,-9
4402,1,1,120,1760,1640
4403,1,0,80,0,-80
4404,1,1,830,1550,720
4405,1,0,80,0,-80
4406,0,0,48,0,-48
4407,0,0,36,0,-36
4408,1,1,497,1216,719
4409,1,1,263,1425,1162
4410,0,0,117,0,-117
4411,0,0,73,0,-73
4412,0,0,57,0,-57
4413,1,0,85,0,-85
4414,1,0,45,0,-45
4415,1,0,69,0,-69
4416,1,0,65,0,-65
4417,0,0,87,0,-87
4418,1,1,277,1323,1046
4419,0,0,41,0,-41
4420,0,0,29,0,-29
4421,1,0,7,0,-7
4422,1,0,166,0,-166
4423,0,0,89,0,-89
4424,1,1,65,1217,1152
4425,0,0,12,0,-12
4426,0,0,12,0,-12
4427,0,0,67,0,-67
4428,0,0,56,0,-56
4429,0,0,13,0,-13
4430,1,0,37,0,-37
4431,0,0,55,0,-55
4432,0,0,74,0,-74
4433,0,0,112,0,-112
4434,0,0,77,0,-77
4435,1,0,65,0,-65
4436,1,1,279,1623,1344
4437,0,0,23,0,-23
4438,1,1,164,1735,1571
4439,1,1,375,1252,877
4440,1,1,362,1307,945
4441,0,0,25,0,-25
4442,0,0,15,0,-15
4443,1,0,12,0,-12
4444,1,0,12,0,-12
4445,1,0,41,0,-41
4446,0,0,53,0,-53
4447,1,1,965,1327,362
4448,0,0,32,0,-32
4449,0,0,14,0,-14
4450,1,0,3,0,-3
4451,0,0,55,0,-55
4452,0,0,28,0,-28
4453,1,1,389,1848,1459
4454,1,0,248,0,-248
4455,0,0,5,0,-5
4456,1,0,31,0,-31
4457,0,0,91,0,-91
4458,0,0,21,0,-21
4459,0,0,107,0,-107
4460,0,0,5,0,-5
4461,1,0,62,0,-62
4462,1,0,17,0,-17
4463,0,0,7,0,-7
4464,0,0,2,0,-2
4465,0,0,26,0,-26
4466,0,0,34,0,-34
4467,0,0,47,0,-47
4468,0,0,3,0,-3
4469,1,0,1,0,-1
4470,0,0,55,0,-55
4471,1,0,43,0,-43
4472,1,0,24,0,-24
4473,1,1,364,3337,2973
4474,0,0,4,0,-4
4475,0,0,14,0,-14
4476,1,0,12,0,-12
4477,1,1,127,1311,1184
4478,1,0,149,0,-149
4479,0,0,21,0,-21
4480,1,0,191,0,-191
4481,1,0,10,0,-10
4482,1,0,44,0,-44
4483,0,0,11,0,-11
4484,1,0,187,0,-187
4485,1,0,20,0,-20
4486,0,0,44,0,-44
4487,1,1,178,1423,1245
4488,1,1,257,1344,1087
4489,1,1,324,1238,914
4490,1,1,168,1808,1640
4491,1,0,49,0,-49
4492,1,1,211,1328,1117
4493,0,0,65,0,-65
4494,0,0,19,0,-19
4495,0,0,99,0,-99
4496,0,0,0,0,0
4497,0,0,90,0,-90
4498,1,0,157,0,-157
4499,1,0,40,0,-40
4500,1,0,35,0,-35
4501,1,1,1310,1724,414
4502,1,0,41,0,-41
4503,1,1,198,1203,1005
4504,1,1,1124,1879,755
4505,0,0,2,0,-2
4506,0,0,13,0,-13
4507,0,0,37,0,-37
4508,0,0,109,0,-109
4509,1,0,17,0,-17
4510,1,0,4,0,-4
4511,0,0,58,0,-58
4512,0,0,36,0,-36
4513,1,0,20,0,-20
4514,1,0,61,0,-61
4515,1,0,57,0,-57
4516,0,0,4,0,-4
4517,1,1,178,2409,2231
4518,0,0,66,0,-66
4519,1,1,1281,2188,907
4520,1,1,217,1704,1487
4521,1,1,1513,1818,305
4522,1,1,461,1241,780
4523,1,1,208,1461,1253
4524,0,0,48,0,-48
4525,1,0,36,0,-36
4526,0,0,64,0,-64
4527,0,0,24,0,-24
4528,1,0,25,0,-25
4529,0,0,28,0,-28
4530,1,1,545,1215,670
4531,0,0,59,0,-59
4532,1,0,99,0,-99
4533,1,0,98,0,-98
4534,1,0,8,0,-8
4535,0,0,10,0,-10
4536,1,1,674,1268,594
4537,1,0,58,0,-58
4538,1,0,14,0,-14
4539,0,0,121,0,-121
4540,1,0,28,0,-28
4541,1,1,202,1279,1077
4542,0,0,19,0,-19
4543,1,1,231,1314,1083
4544,1,1,211,3187,2976
4545,1,1,486,1529,1043
4546,0,0,4,0,-4
4547,1,0,8,0,-8
4548,1,1,152,1979,1827
4549,0,0,12,0,-12
4550,1,0,70,0,-70
4551,0,0,141,0,-141
4552,1,1,329,1246,917
4553,1,0,145,0,-145
4554,0,0,44,0,-44
4555,1,0,22,0,-22
4556,1,1,176,1271,1095
4557,1,1,218,2129,1911
4558,0,0,27,0,-27
4559,1,0,49,0,-49
4560,0,0,8,0,-8
4561,1,1,84,1427,1343
4562,1,1,150,1372,1222
4563,0,0,11,0,-11
4564,1,0,21,0,-21
4565,1,1,493,1200,707
4566,1,0,40,0,-40
4567,1,1,396,1708,1312
4568,1,0,50,0,-50
4569,1,0,45,0,-45
4570,0,0,45,0,-45
4571,1,0,5,0,-5
4572,0,0,61,0,-61
4573,1,1,126,3156,3030
4574,0,0,162,0,-162
4575,1,0,56,0,-56
4576,1,0,42,0,-42
4577,1,0,90,0,-90
4578,0,0,13,0,-13
4579,1,0,66,0,-66
4580,1,0,121,0,-121
4581,1,1,320,1483,1163
4582,1,1,31,1508,1477
4583,0,0,13,0,-13
4584,0,0,10,0,-10
4585,1,0,6,0,-6
4586,0,0,0,0,0
4587,1,0,71,0,-71
4588,0,0,135,0,-135
4589,1,1,433,1519,1086
4590,0,0,31,0,-31
4591,1,1,779,1353,574
4592,0,0,6,0,-6
4593,1,1,89,1647,1558
4594,0,0,31,0,-31
4595,0,0,51,0,-51
4596,1,1,311,1412,1101
4597,1,0,4,0,-4
4598,1,0,18,0,-18
4599,1,0,39,0,-39
4600,1,1,533,1201,668
4601,1,0,149,0,-149
4602,0,0,19,0,-19
4603,1,0,28,0,-28
4604,1,0,12,0,-12
4605,0,0,21,0,-21
4606,0,0,26,0,-26
4607,1,1,982,1314,332
4608,1,1,998,2025,1027
4609,1,1,1373,1340,-33
4610,1,0,9,0,-9
4611,0,0,6,0,-6
4612,1,1,225,1280,1055
4613,1,0,9,0,-9
4614,1,0,27,0,-27
4615,0,0,32,0,-32
4616,1,0,43,0,-43
4617,1,1,683,1765,1082
4618,1,0,14,0,-14
4619,1,1,520,1497,977
4620,1,0,0,0,0
4621,1,1,346,1381,1035
4622,1,1,513,1246,733
4623,0,0,20,0,-20
4624,1,0,35,0,-35
4625,1,0,3,0,-3
4626,0,0,33,0,-33
4627,0,0,10,0,-10
4628,0,0,61,0,-61
4629,1,0,0,0,0
4630,1,0,60,0,-60
4631,1,1,809,1837,1028
4632,1,1,442,1211,769
4633,0,0,21,0,-21
4634,1,0,22,0,-22
4635,0,0,13,0,-13
4636,1,1,82,1571,1489
4637,1,1,97,1315,1218
4638,1,1,160,1200,1040
4639,0,0,103,0,-103
4640,0,0,25,0,-25
4641,1,1,235,1301,1066
4642,1,1,271,1341,1070
4643,0,0,34,0,-34
4644,0,0,96,0,-96
4645,0,0,35,0,-35
4646,1,1,158,1205,1047
4647,0,0,92,0,-92
4648,1,1,116,1314,1198
4649,1,0,13,0,-13
4650,1,0,64,0,-64
4651,0,0,29,0,-29
4652,1,0,187,0,-187
4653,0,0,103,0,-103
4654,1,0,128,0,-128
4655,0,0,5,0,-5
4656,0,0,5,0,-5
4657,1,0,111,0,-111
4658,1,0,22,0,-22
4659,1,0,1,0,-1
4660,1,0,96,0,-96
4661,0,0,188,0,-188
4662,1,1,273,1416,1143
4663,1,0,19,0,-19
4664,1,1,141,1695,1554
4665,1,0,12,0,-12
4666,1,0,63,0,-63
4667,1,1,51,1405,1354
4668,1,1,612,2011,1399
4669,1,0,69,0,-69
4670,0,0,50,0,-50
4671,0,0,108,0,-108
4672,1,0,15,0,-15
4673,0,0,106,0,-106
4674,0,0,0,0,0
4675,1,0,33,0,-33
4676,0,0,32,0,-32
4677,0,0,67,0,-67
4678,1,1,309,1780,1471
4679,1,1,1519,1219,-300
4680,0,0,19,0,-19
4681,1,0,6,0,-6
4682,1,1,224,1288,1064
4683,0,0,44,0,-44
4684,0,0,77,0,-77
4685,1,0,142,0,-142
4686,1,1,91,1232,1141
4687,1,1,1011,1307,296
4688,1,1,90,1452,1362
4689,1,0,15,0,-15
4690,1,0,2,0,-2
4691,0,0,45,0,-45
4692,0,0,16,0,-16
4693,1,0,27,0,-27
4694,1,1,573,1570,997
4695,1,1,767,1359,592
4696,0,0,28,0,-28
4697,1,0,16,0,-16
4698,0,0,40,0,-40
4699,0,0,59,0,-59
4700,1,1,191,1283,1092
4701,1,0,98,0,-98
4702,1,1,69,1357,1288
4703,1,1,426,1227,801
4704,1,0,8,0,-8
4705,0,0,46,0,-46
4706,0,0,3,0,-3
4707,1,1,313,1449,1136
4708,0,0,4,0,-4
4709,0,0,12,0,-12
4710,0,0,12,0,-12
4711,1,1,336,1253,917
4712,0,0,20,0,-20
4713,0,0,6,0,-6
4714,0,0,3,0,-3
4715,0,0,44,0,-44
4716,1,0,13,0,-13
4717,1,1,756,2342,1586
4718,1,0,17,0,-17
4719,1,0,41,0,-41
4720,1,1,1720,1288,-432
4721,1,1,38,1251,1213
4722,0,0,24,0,-24
4723,1,1,697,1290,593
4724,0,0,27,0,-27
4725,1,1,362,1640,1278
4726,0,0,37,0,-37
4727,1,1,303,1521,1218
4728,1,0,33,0,-33
4729,1,1,40,1327,1287
4730,1,1,103,1682,1579
4731,0,0,37,0,-37
4732,1,1,898,1662,764
4733,1,1,665,1578,913
4734,1,0,46,0,-46
4735,0,0,115,0,-115
4736,0,0,74,0,-74
4737,1,0,151,0,-151
4738,1,1,1117,1391,274
4739,1,0,32,0,-32
4740,1,1,274,1563,1289
4741,0,0,35,0,-35
4742,0,0,127,0,-127
4743,0,0,31,0,-31
4744,0,0,18,0,-18
4745,0,0,5,0,-5
4746,0,0,63,0,-63
4747,1,1,112,1221,1109
4748,1,0,38,0,-38
4749,1,0,20,0,-20
4750,0,0,2,0,-2
4751,1,1,166,2508,2342
4752,0,0,0,0,0
4753,0,0,168,0,-168
4754,1,0,26,0,-26
4755,1,1,671,3772,3101
4756,1,1,1059,1208,149
4757,1,0,47,0,-47
4758,1,0,64,0,-64
4759,1,1,42,1257,1215
4760,0,0,38,0,-38
4761,1,1,1486,1228,-258
4762,1,0,85,0,-85
4763,0,0,70,0,-70
4764,1,1,883,1270,387
4765,1,1,289,1660,1371
4766,1,0,17,0,-17
4767,1,1,31,1929,1898
4768,1,1,811,1349,538
4769,0,0,47,0,-47
4770,1,0,12,0,-12
4771,1,1,34,1271,1237
4772,0,0,78,0,-78
4773,0,0,60,0,-60
4774,1,0,41,0,-41
4775,1,0,54,0,-54
4776,1,1,957,1989,1032
4777,1,0,50,0,-50
4778,1,1,551,1376,825
4779,0,0,97,0,-97
4780,1,1,625,1467,842
4781,1,0,76,0,-76
4782,0,0,160,0,-160
4783,1,0,16,0,-16
4784,0,0,19,0,-19
4785,0,0,11,0,-11
4786,1,0,0,0,0
4787,1,1,400,1425,1025
4788,1,0,18,0,-18
4789,1,0,26,0,-26
4790,0,0,9,0,-9
4791,1,1,2157,1264,-893
4792,1,1,232,1560,1328
4793,1,1,87,1245,1158
4794,1,0,48,0,-48
4795,1,1,650,1807,1157
4796,1,1,42,1206,1164
4797,1,0,16,0,-16
4798,0,0,29,0,-29
4799,1,0,190,0,-190
4800,1,0,82,0,-82
4801,0,0,114,0,-114
4802,1,0,39,0,-39
4803,1,0,8,0,-8
4804,0,0,82,0,-82
4805,1,1,256,1618,1362
4806,1,1,294,1274,980
4807,1,0,4,0,-4
4808,0,0,97,0,-97
4809,0,0,42,0,-42
4810,0,0,1,0,-1
4811,0,0,77,0,-77
4812,1,1,77,2178,2101
4813,1,1,385,1374,989
4814,0,0,58,0,-58
4815,0,0,136,0,-136
4816,0,0,85,0,-85
4817,1,1,303,1202,899
4818,1,0,15,0,-15
4819,1,1,506,1928,1422
4820,1,0,48,0,-48
4821,0,0,115,0,-115
4822,1,1,355,1314,959
4823,1,0,115,0,-115
4824,1,1,450,1494,1044
4825,1,1,306,1688,1382
4826,1,0,15,0,-15
4827,0,0,25,0,-25
4828,1,1,222,1307,1085
4829,0,0,21,0,-21
4830,1,0,3,0,-3
4831,1,0,75,0,-75
4832,0,0,16,0,-16
4833,1,0,56,0,-56
4834,1,1,296,2167,1871
4835,1,1,79,3243,3164
4836,0,0,311,0,-311
4837,1,1,118,1645,1527
4838,1,0,9,0,-9
4839,1,0,7,0,-7
4840,0,0,0,0,0
4841,1,1,20,1359,1339
4842,1,1,911,1200,289
4843,1,1,1363,1399,36
4844,1,1,183,3134,2951
4845,1,1,1161,1371,210
4846,0,0,50,0,-50
4847,1,0,3,0,-3
4848,1,0,74,0,-74
4849,0,0,57,0,-57
4850,0,0,15,0,-15
4851,1,1,1014,1207,193
4852,0,0,85,0,-85
4853,1,0,39,0,-39
4854,1,1,83,1967,1884
4855,1,1,488,1693,1205
4856,0,0,1,0,-1
4857,0,0,11,0,-11
4858,0,0,106,0,-106
4859,0,0,27,0,-27
4860,0,0,5,0,-5
4861,0,0,25,0,-25
4862,1,1,2428,1409,-1019
4863,0,0,39,0,-39
4864,0,0,78,0,-78
4865,1,0,187,0,-187
4866,1,1,114,1267,1153
4867,1,1,647,1609,962
4868,1,1,718,1793,1075
4869,1,0,26,0,-26
4870,1,1,324,1373,1049
4871,1,1,416,1212,796
4872,0,0,45,0,-45
4873,1,0,11,0,-11
4874,0,0,171,0,-171
4875,1,1,810,1212,402
4876,1,1,183,1461,1278
4877,1,0,18,0,-18
4878,1,1,326,1846,1520
4879,1,0,0,0,0
4880,1,0,143,0,-143
4881,0,0,42,0,-42
4882,1,0,12,0,-12
4883,0,0,33,0,-33
4884,1,1,483,1620,1137
4885,1,0,11,0,-11
4886,0,0,76,0,-76
4887,1,0,31,0,-31
4888,1,1,515,1265,750
4889,1,0,23,0,-23
4890,1,0,33,0,-33
4891,1,0,64,0,-64
4892,1,0,54,0,-54
4893,1,1,195,1800,1605
4894,0,0,6,0,-6
4895,1,0,43,0,-43
4896,0,0,47,0,-47
4897,1,1,644,1315,671
4898,1,0,151,0,-151
4899,1,1,452,1233,781
4900,0,0,12,0,-12
4901,0,0,35,0,-35
4902,0,0,6,0,-6
4903,1,0,7,0,-7
4904,1,0,30,0,-30
4905,0,0,11,0,-11
4906,1,1,396,1583,1187
4907,1,0,2,0,-2
4908,0,0,46,0,-46
4909,0,0,80,0,-80
4910,1,0,35,0,-35
4911,0,0,66,0,-66
4912,0,0,28,0,-28
4913,0,0,6,0,-6
4914,0,0,2,0,-2
4915,1,0,117,0,-117
4916,1,1,40,1271,1231
4917,0,0,58,0,-58
4918,1,0,52,0,-52
4919,0,0,142,0,-142
4920,1,0,18,0,-18
4921,0,0,70,0,-70
4922,1,1,286,1341,1055
4923,0,0,24,0,-24
4924,1,0,91,0,-91
4925,1,0,22,0,-22
4926,1,1,660,1213,553
4927,1,1,383,1291,908
4928,0,0,8,0,-8
4929,1,0,26,0,-26
4930,0,0,25,0,-25
4931,1,0,15,0,-15
4932,0,0,15,0,-15
4933,1,1,480,1483,1003
4934,1,0,7,0,-7
4935,0,0,40,0,-40
4936,0,0,29,0,-29
4937,1,0,50,0,-50
4938,0,0,22,0,-22
4939,0,0,87,0,-87
4940,1,1,1952,2171,219
4941,0,0,66,0,-66
4942,1,0,27,0,-27
4943,1,0,43,0,-43
4944,0,0,24,0,-24
4945,0,0,42,0,-42
4946,0,0,10,0,-10
4947,0,0,125,0,-125
4948,0,0,1,0,-1
4949,0,0,34,0,-34
4950,0,0,16,0,-16
4951,0,0,40,0,-40
4952,0,0,26,0,-26
4953,1,1,211,1534,1323
4954,1,0,40,0,-40
4955,0,0,42,0,-42
4956,0,0,80,0,-80
4957,0,0,3,0,-3
4958,0,0,43,0,-43
4959,0,0,26,0,-26
4960,0,0,99,0,-99
4961,1,0,33,0,-33
4962,1,1,244,1597,1353
4963,0,0,20,0,-20
4964,0,0,146,0,-146
4965,1,0,6,0,-6
4966,1,0,25,0,-25
4967,0,0,64,0,-64
4968,0,0,65,0,-65
4969,0,0,13,0,-13
4970,1,0,84,0,-84
4971,0,0,25,0,-25
4972,1,0,16,0,-16
4973,1,1,192,1872,1680
4974,1,0,21,0,-21
4975,1,1,612,2638,2026
4976,0,0,70,0,-70
4977,1,0,50,0,-50
4978,1,1,191,1216,1025
4979,1,1,323,1342,1019
4980,1,1,243,1419,1176
4981,1,1,294,1410,1116
4982,0,0,2,0,-2
4983,1,1,1347,1512,165
4984,1,1,970,1514,544
4985,1,0,35,0,-35
4986,1,0,7,0,-7
4987,1,0,36,0,-36
4988,1,0,1,0,-1
4989,0,0,17,0,-17
4990,1,1,191,1818,1627
4991,1,0,3,0,-3
4992,1,1,300,1214,914
4993,1,0,30,0,-30
4994,1,1,503,1222,719
4995,0,0,55,0,-55
4996,1,1,768,2219,1451
4997,1,0,52,0,-52
4998,0,0,132,0,-132
4999,0,0,115,0,-115
5000,1,0,242,0,-242
5001,1,1,2261,1231,-1030
5002,1,1,304,1722,1418
5003,0,0,31,0,-31
5004,1,1,222,1201,979
5005,0,0,68,0,-68
5006,1,1,84,1508,1424
5007,0,0,42,0,-42
5008,1,1,385,3125,2740
5009,0,0,48,0,-48
5010,1,0,33,0,-33
5011,1,0,83,0,-83
5012,0,0,7,0,-7
5013,0,0,30,0,-30
5014,1,0,6,0,-6
5015,0,0,331,0,-331
5016,0,0,88,0,-88
5017,1,1,657,1307,650
5018,0,0,31,0,-31
5019,1,1,502,1206,704
5020,0,0,10,0,-10
5021,1,1,194,1380,1186
5022,0,0,49,0,-49
5023,1,0,88,0,-88
5024,0,0,70,0,-70
5025,0,0,3,0,-3
5026,1,1,135,2146,2011
5027,1,1,97,1346,1249
5028,0,0,9,0,-9
5029,1,1,1084,1624,540
5030,0,0,86,0,-86
5031,0,0,35,0,-35
5032,1,1,315,1664,1349
5033,1,1,399,1850,1451
5034,0,0,128,0,-128
5035,1,1,338,1238,900
5036,1,0,64,0,-64
5037,0,0,100,0,-100
5038,0,0,32,0,-32
5039,0,0,16,0,-16
5040,0,0,39,0,-39
5041,0,0,19,0,-19
5042,0,0,50,0,-50
5043,0,0,41,0,-41
5044,1,0,112,0,-112
5045,1,0,20,0,-20
5046,1,0,89,0,-89
5047,0,0,51,0,-51
5048,1,0,14,0,-14
5049,0,0,133,0,-133
5050,0,0,1,0,-1
5051,1,0,4,0,-4
5052,0,0,39,0,-39
5053,1,0,59,0,-59
5054,0,0,37,0,-37
5055,1,1,810,2582,1772
5056,0,0,33,0,-33
5057,1,1,848,1241,393
5058,0,0,148,0,-148
5059,1,1,203,1268,1065
5060,1,1,1354,1679,325
5061,0,0,36,0,-36
5062,0,0,6,0,-6
5063,0,0,37,0,-37
5064,1,1,69,1343,1274
5065,1,0,25,0,-25
5066,1,0,17,0,-17
5067,0,0,124,0,-124
5068,1,0,37,0,-37
5069,1,0,69,0,-69
5070,0,0,120,0,-120
5071,0,0,215,0,-215
5072,1,1,116,1560,1444
5073,1,0,24,0,-24
5074,0,0,13,0,-13
5075,0,0,33,0,-33
5076,0,0,39,0,-39
5077,0,0,86,0,-86
5078,1,0,44,0,-44
5079,1,1,174,1450,1276
5080,1,0,9,0,-9
5081,0,0,22,0,-22
5082,0,0,33,0,-33
5083,1,1,702,1201,499
5084,1,0,5,0,-5
5085,0,0,21,0,-21
5086,1,1,147,1459,1312
5087,1,1,340,1210,870
5088,1,0,47,0,-47
5089,1,0,128,0,-128
5090,1,1,47,2966,2919
5091,0,0,45,0,-45
5092,1,0,18,0,-18
5093,0,0,129,0,-129
5094,0,0,60,0,-60
5095,1,0,77,0,-77
5096,0,0,27,0,-27
5097,0,0,52,0,-52
5098,1,1,25,1214,1189
5099,1,0,3,0,-3
5100,0,0,8,0,-8
5101,1,0,15,0,-15
5102,0,0,81,0,-81
5103,0,0,29,0,-29
5104,0,0,5,0,-5
5105,0,0,172,0,-172
5106,1,0,73,0,-73
5107,0,0,10,0,-10
5108,1,1,690,1422,732
5109,0,0,17,0,-17
5110,0,0,19,0,-19
5111,1,0,15,0,-15
5112,0,0,71,0,-71
5113,0,0,12,0,-12
5114,0,0,0,0,0
5115,0,0,15,0,-15
5116,1,1,2539,3103,564
5117,1,0,73,0,-73
5118,1,0,140,0,-140
5119,1,1,234,1618,1384
5120,0,0,1,0,-1
5121,1,0,90,0,-90
5122,1,1,1055,1223,168
5123,1,1,590,1424,834
5124,0,0,98,0,-98
5125,1,1,1207,1805,598
5126,1,0,37,0,-37
5127,0,0,191,0,-191
5128,0,0,2,0,-2
5129,1,1,491,1362,871
5130,1,0,10,0,-10
5131,1,1,375,1236,861
5132,1,0,58,0,-58
5133,1,1,761,1498,737
5134,1,0,128,0,-128
5135,0,0,15,0,-15
5136,0,0,31,0,-31
5137,1,0,1,0,-1
5138,1,0,13,0,-13
5139,0,0,0,0,0
5140,0,0,72,0,-72
5141,1,0,51,0,-51
5142,0,0,25,0,-25
5143,1,0,63,0,-63
5144,0,0,39,0,-39
5145,1,0,24,0,-24
5146,0,0,3,0,-3
5147,0,0,3,0,-3
5148,0,0,0,0,0
5149,1,0,4,0,-4
5150,1,1,577,1881,1304
5151,1,1,302,1211,909
5152,0,0,64,0,-64
5153,1,1,431,2360,1929
5154,0,0,11,0,-11
5155,1,0,79,0,-79
5156,1,1,600,1393,793
5157,0,0,19,0,-19
5158,0,0,0,0,0
5159,1,1,1185,1362,177
5160,1,1,564,1287,723
5161,1,0,35,0,-35
5162,1,0,127,0,-127
5163,1,0,27,0,-27
5164,0,0,19,0,-19
5165,1,0,50,0,-50
5166,1,1,251,1365,1114
5167,1,0,117,0,-117
5168,1,1,90,1310,1220
5169,0,0,10,0,-10
5170,1,1,546,2012,1466
5171,0,0,32,0,-32
5172,0,0,9,0,-9
5173,1,1,605,1424,819
5174,1,1,745,1494,749
5175,0,0,50,0,-50
5176,1,1,265,1998,1733
5177,0,0,21,0,-21
5178,1,1,1438,1223,-215
5179,0,0,111,0,-111
5180,1,1,529,2497,1968
5181,0,0,36,0,-36
5182,1,1,144,1376,1232
5183,1,0,26,0,-26
5184,1,1,423,1275,852
5185,0,0,8,0,-8
5186,1,1,1129,1584,455
5187,0,0,8,0,-8
5188,0,0,78,0,-78
5189,0,0,12,0,-12
5190,1,0,192,0,-192
5191,1,0,25,0,-25
5192,1,1,573,2310,1737
5193,1,1,361,1418,1057
5194,0,0,26,0,-26
5195,0,0,2,0,-2
5196,0,0,28,0,-28
5197,1,1,290,1245,955
5198,1,1,148,1477,1329
5199,1,1,825,1445,620
5200,0,0,8,0,-8
5201,0,0,45,0,-45
5202,1,0,1,0,-1
5203,1,1,262,1355,1093
5204,1,0,84,0,-84
5205,0,0,32,0,-32
5206,0,0,54,0,-54
5207,0,0,30,0,-30
5208,0,0,27,0,-27
5209,0,0,29,0,-29
5210,0,0,17,0,-17
5211,1,0,101,0,-101
5212,0,0,91,0,-91
5213,1,0,43,0,-43
5214,1,0,3,0,-3
5215,1,1,570,2079,1509
5216,0,0,44,0,-44
5217,0,0,126,0,-126
5218,1,0,50,0,-50
5219,1,1,302,1646,1344
5220,1,0,40,0,-40
5221,1,0,14,0,-14
5222,0,0,83,0,-83
5223,1,0,66,0,-66
5224,1,1,1710,1309,-401
5225,1,1,188,1475,1287
5226,0,0,13,0,-13
5227,0,0,11,0,-11
5228,1,1,809,1429,620
5229,1,0,1,0,-1
5230,1,0,54,0,-54
5231,0,0,26,0,-26
5232,1,0,14,0,-14
5233,1,1,363,4908,4545
5234,0,0,10,0,-10
5235,1,0,27,0,-27
5236,1,1,695,2102,1407
5237,1,1,467,1759,1292
5238,0,0,35,0,-35
5239,0,0,11,0,-11
5240,1,1,224,1420,1196
5241,0,0,69,0,-69
5242,1,1,757,1912,1155
5243,1,1,1126,1224,98
5244,1,1,675,1462,787
5245,0,0,4,0,-4
5246,0,0,49,0,-49
5247,1,0,35,0,-35
5248,0,0,23,0,-23
5249,1,0,60,0,-60
5250,1,0,44,0,-44
5251,0,0,82,0,-82
5252,1,1,340,1206,866
5253,1,1,86,1695,1609
5254,1,0,21,0,-21
5255,0,0,43,0,-43
5256,1,1,243,1595,1352
5257,0,0,220,0,-220
5258,1,0,42,0,-42
5259,1,0,18,0,-18
5260,1,0,58,0,-58
5261,1,0,93,0,-93
5262,0,0,109,0,-109
5263,1,0,6,0,-6
5264,1,0,17,0,-17
5265,0,0,17,0,-17
5266,0,0,86,0,-86
5267,1,0,2,0,-2
5268,0,0,57,0,-57
5269,1,1,408,1289,881
5270,1,0,19,0,-19
5271,0,0,27,0,-27
5272,0,0,84,0,-84
5273,1,0,92,0,-92
5274,1,0,71,0,-71
5275,1,1,34,2943,2909
5276,1,1,220,1313,1093
5277,0,0,29,0,-29
5278,0,0,149,0,-149
5279,0,0,4,0,-4
5280,0,0,65,0,-65
5281,1,0,1,0,-1
5282,0,0,43,0,-43
5283,0,0,184,0,-184
5284,0,0,58,0,-58
5285,1,1,458,1722,1264
5286,1,1,815,1650,835
5287,0,0,12,0,-12
5288,0,0,53,0,-53
5289,0,0,10,0,-10
5290,0,0,9,0,-9
5291,1,0,7,0,-7
5292,1,0,6,0,-6
5293,1,1,850,1681,831
5294,0,0,113,0,-113
5295,0,0,107,0,-107
5296,0,0,45,0,-45
5297,1,0,62,0,-62
5298,1,0,16,0,-16
5299,1,0,119,0,-119
5300,0,0,160,0,-160
5301,1,0,72,0,-72
5302,1,0,14,0,-14
5303,1,0,18,0,-18
5304,1,0,24,0,-24
5305,1,0,53,0,-53
5306,0,0,8,0,-8
5307,1,1,514,1408,894
5308,0,0,25,0,-25
5309,1,0,34,0,-34
5310,0,0,14,0,-14
5311,1,1,72,1309,1237
5312,1,0,75,0,-75
5313,1,0,16,0,-16
5314,1,0,73,0,-73
5315,1,1,599,1710,1111
5316,1,1,508,3480,2972
5317,1,1,362,1490,1128
5318,1,0,107,0,-107
5319,0,0,78,0,-78
5320,0,0,55,0,-55
5321,1,1,255,1368,1113
5322,1,0,6,0,-6
5323,0,0,7,0,-7
5324,1,0,35,0,-35
5325,0,0,85,0,-85
5326,0,0,113,0,-113
5327,1,0,36,0,-36
5328,1,1,239,1541,1302
5329,1,0,47,0,-47
5330,1,0,47,0,-47
5331,0,0,49,0,-49
5332,0,0,8,0,-8
5333,1,0,95,0,-95
5334,0,0,25,0,-25
5335,1,1,292,1344,1052
5336,1,1,1582,1584,2
5337,1,0,1,0,-1
5338,0,0,2,0,-2
5339,0,0,51,0,-51
5340,1,0,102,0,-102
5341,1,0,99,0,-99
5342,1,1,3008,1745,-1263
5343,1,0,7,0,-7
5344,0,0,78,0,-78
5345,1,1,1245,1345,100
5346,0,0,10,0,-10
5347,1,0,48,0,-48
5348,0,0,3,0,-3
5349,1,1,364,1512,1148
5350,1,1,74,2534,2460
5351,1,1,282,1213,931
5352,1,1,521,1727,1206
5353,1,0,19,0,-19
5354,1,1,1449,1316,-133
5355,1,0,128,0,-128
5356,1,0,66,0,-66
5357,0,0,10,0,-10
5358,1,0,1,0,-1
5359,1,0,30,0,-30
5360,1,1,366,2081,1715
5361,1,0,79,0,-79
5362,1,1,136,1898,1762
5363,1,0,34,0,-34
5364,1,0,13,0,-13
5365,1,1,1081,2169,1088
5366,1,1,271,1259,988
5367,1,1,794,2845,2051
5368,1,0,105,0,-105
5369,0,0,57,0,-57
5370,0,0,18,0,-18
5371,1,0,18,0,-18
5372,1,0,115,0,-115
5373,1,1,720,1513,793
5374,1,1,771,1754,983
5375,1,1,505,3364,2859
5376,0,0,125,0,-125
5377,1,1,87,1260,1173
5378,0,0,27,0,-27
5379,0,0,73,0,-73
5380,1,0,130,0,-130
5381,0,0,0,0,0
5382,0,0,26,0,-26
5383,1,0,4,0,-4
5384,1,1,631,1239,608
5385,1,0,9,0,-9
5386,1,0,99,0,-99
5387,0,0,8,0,-8
5388,1,0,12,0,-12
5389,1,1,270,1419,1149
5390,0,0,0,0,0
5391,0,0,14,0,-14
5392,0,0,24,0,-24
5393,0,0,104,0,-104
5394,1,1,413,2183,1770
5395,0,0,110,0,-110
5396,1,0,27,0,-27
5397,0,0,2,0,-2
5398,1,0,19,0,-19
5399,0,0,157,0,-157
5400,0,0,28,0,-28
5401,1,1,144,1424,1280
5402,1,0,10,0,-10
5403,0,0,6,0,-6
5404,0,0,99,0,-99
5405,1,0,22,0,-22
5406,1,1,554,1689,1135
5407,0,0,26,0,-26
5408,0,0,21,0,-21
5409,0,0,1,0,-1
5410,1,0,20,0,-20
5411,0,0,21,0,-21
5412,0,0,252,0,-252
5413,1,1,217,1366,1149
5414,1,1,1024,1585,561
5415,1,1,494,1274,780
5416,1,1,288,1694,1406
5417,0,0,9,0,-9
5418,1,1,168,1360,1192
5419,0,0,37,0,-37
5420,0,0,29,0,-29
5421,1,0,15,0,-15
5422,1,1,226,1298,1072
5423,0,0,11,0,-11
5424,1,0,23,0,-23
5425,1,1,888,1874,986
5426,1,0,77,0,-77
5427,1,1,114,2437,2323
5428,0,0,36,0,-36
5429,1,1,350,1602,1252
5430,0,0,0,0,0
5431,1,0,167,0,-167
5432,1,0,3,0,-3
5433,1,0,9,0,-9
5434,0,0,68,0,-68
5435,1,0,14,0,-14
5436,1,1,198,1262,1064
5437,1,1,306,1422,1116
5438,1,1,768,1213,445
5439,0,0,1,0,-1
5440,0,0,65,0,-65
5441,0,0,14,0,-14
5442,1,1,169,1259,1090
5443,1,0,137,0,-137
5444,1,1,297,1211,914
5445,1,1,221,1383,1162
5446,1,0,39,0,-39
5447,1,1,202,1377,1175
5448,1,1,97,1767,1670
5449,1,1,1037,1387,350
5450,1,1,1475,1421,-54
5451,0,0,0,0,0
5452,1,0,27,0,-27
5453,1,0,1,0,-1
5454,1,1,602,1452,850
5455,1,0,81,0,-81
5456,0,0,3,0,-3
5457,1,1,169,1246,1077
5458,1,0,110,0,-110
5459,1,0,123,0,-123
5460,0,0,1,0,-1
5461,0,0,34,0,-34
5462,1,1,237,3925,3688
5463,0,0,13,0,-13
5464,0,0,76,0,-76
5465,0,0,5,0,-5
5466,1,1,595,1526,931
5467,1,1,99,1416,1317
5468,1,1,1580,1320,-260
5469,0,0,20,0,-20
5470,1,1,842,2179,1337
5471,1,1,170,1240,1070
5472,1,0,160,0,-160
5473,1,1,196,1244,1048
5474,1,1,1022,1273,251
5475,1,0,4,0,-4
5476,1,0,71,0,-71
5477,1,0,62,0,-62
5478,0,0,56,0,-56
5479,0,0,2,0,-2
5480,0,0,16,0,-16
5481,0,0,44,0,-44
5482,1,1,282,1421,1139
5483,0,0,49,0,-49
5484,0,0,11,0,-11
5485,0,0,35,0,-35
5486,1,0,19,0,-19
5487,1,0,51,0,-51
5488,0,0,10,0,-10
5489,0,0,125,0,-125
5490,1,1,700,1378,678
5491,1,1,83,1469,1386
5492,0,0,20,0,-20
5493,1,0,4,0,-4
5494,1,0,11,0,-11
5495,0,0,8,0,-8
5496,1,1,560,1215,655
5497,0,0,13,0,-13
5498,1,1,121,1571,1450
5499,1,1,186,1365,1179
5500,0,0,126,0,-126
5501,1,0,16,0,-16
5502,0,0,0,0,0
5503,1,1,1690,1302,-388
5504,1,1,251,1207,956
5505,1,1,14,2548,2534
5506,0,0,1,0,-1
5507,0,0,82,0,-82
5508,1,1,708,1271,563
5509,0,0,32,0,-32
5510,1,1,1381,1319,-62
5511,0,0,11,0,-11
5512,0,0,27,0,-27
5513,1,0,54,0,-54
5514,1,1,56,1327,1271
5515,1,1,715,1233,518
5516,1,0,3,0,-3
5517,0,0,36,0,-36
5518,0,0,75,0,-75
5519,1,1,1045,1560,515
5520,1,1,120,2188,2068
5521,0,0,13,0,-13
5522,0,0,7,0,-7
5523,0,0,19,0,-19
5524,1,0,94,0,-94
5525,1,0,12,0,-12
5526,1,1,1129,1583,454
5527,0,0,7,0,-7
5528,1,0,42,0,-42
5529,1,1,252,1326,1074
5530,1,0,15,0,-15
5531,1,1,90,1545,1455
5532,1,0,9,0,-9
5533,1,0,1,0,-1
5534,0,0,2,0,-2
5535,1,1,642,1654,1012
5536,1,1,60,1262,1202
5537,1,0,9,0,-9
5538,1,0,96,0,-96
5539,1,1,314,1405,1091
5540,0,0,8,0,-8
5541,0,0,5,0,-5
5542,1,0,10,0,-10
5543,1,0,55,0,-55
5544,1,1,316,1866,1550
5545,0,0,15,0,-15
5546,1,0,14,0,-14
5547,1,0,47,0,-47
5548,1,1,389,1523,1134
5549,1,1,89,1922,1833
5550,1,1,559,1216,657
5551,1,0,1,0,-1
5552,1,1,107,1352,1245
5553,1,0,29,0,-29
5554,1,1,236,1503,1267
5555,0,0,23,0,-23
5556,0,0,27,0,-27
5557,1,1,397,2558,2161
5558,1,0,69,0,-69
5559,1,1,972,1506,534
5560,0,0,179,0,-179
5561,0,0,137,0,-137
5562,0,0,30,0,-30
5563,0,0,46,0,-46
5564,0,0,6,0,-6
5565,1,1,173,1307,1134
5566,0,0,28,0,-28
5567,0,0,23,0,-23
5568,1,0,74,0,-74
5569,0,0,75,0,-75
5570,0,0,18,0,-18
5571,1,1,831,1289,458
5572,1,1,189,1521,1332
5573,1,0,33,0,-33
5574,1,1,1225,1261,36
5575,1,1,331,2298,1967
5576,0,0,21,0,-21
5577,0,0,113,0,-113
5578,0,0,54,0,-54
5579,1,1,2955,1414,-1541
5580,0,0,37,0,-37
5581,1,0,27,0,-27
5582,1,1,88,2471,2383
5583,1,0,3,0,-3
5584,0,0,38,0,-38
5585,0,0,2,0,-2
5586,1,1,21,1252,1231
5587,0,0,13,0,-13
5588,0,0,0,0,0
5589,1,0,36,0,-36
5590,1,0,42,0,-42
5591,1,1,236,1318,1082
5592,0,0,190,0,-190
5593,1,1,149,2458,2309
5594,0,0,77,0,-77
5595,0,0,81,0,-81
5596,0,0,11,0,-11
5597,1,1,154,1452,1298
5598,1,1,98,1616,1518
5599,0,0,6,0,-6
5600,0,0,14,0,-14
5601,1,0,94,0,-94
5602,1,1,224,1352,1128
5603,1,0,93,0,-93
5604,1,1,1240,1344,104
5605,1,1,55,1313,1258
5606,1,0,32,0,-32
5607,0,0,5,0,-5
5608,1,0,67,0,-67
5609,1,1,970,2324,1354
5610,1,1,621,1578,957
5611,1,0,34,0,-34
5612,0,0,25,0,-25
5613,0,0,8,0,-8
5614,0,0,48,0,-48
5615,1,0,4,0,-4
5616,1,1,365,1618,1253
5617,0,0,41,0,-41
5618,0,0,14,0,-14
5619,1,1,459,1815,1356
5620,0,0,19,0,-19
5621,1,1,479,1782,1303
5622,0,0,36,0,-36
5623,0,0,49,0,-49
5624,1,1,999,1250,251
5625,1,0,129,0,-129
5626,1,0,5,0,-5
5627,1,0,176,0,-176
5628,1,1,367,2246,1879
5629,0,0,99,0,-99
5630,1,0,31,0,-31
5631,1,0,7,0,-7
5632,1,1,383,1246,863
5633,1,1,288,1741,1453
5634,0,0,165,0,-165
5635,1,1,1764,2302,538
5636,1,1,187,1605,1418
5637,0,0,56,0,-56
5638,0,0,153,0,-153
5639,1,0,25,0,-25
5640,0,0,7,0,-7
5641,1,1,426,1260,834
5642,1,0,69,0,-69
5643,1,1,712,1248,536
5644,0,0,80,0,-80
5645,0,0,54,0,-54
5646,1,1,734,1292,558
5647,0,0,99,0,-99
5648,1,1,3520,1255,-2265
5649,1,1,290,1738,1448
5650,0,0,6,0,-6
5651,0,0,27,0,-27
5652,1,0,65,0,-65
5653,1,0,23,0,-23
5654,0,0,281,0,-281
5655,1,0,29,0,-29
5656,0,0,48,0,-48
5657,1,0,6,0,-6
5658,1,1,364,1569,1205
5659,1,1,454,1322,868
5660,0,0,30,0,-30
5661,1,0,41,0,-41
5662,0,0,6,0,-6
5663,0,0,29,0,-29
5664,1,1,430,1233,803
5665,1,1,1288,1386,98
5666,0,0,21,0,-21
5667,0,0,29,0,-29
5668,0,0,71,0,-71
5669,1,0,33,0,-33
5670,1,1,146,1258,1112
5671,1,0,21,0,-21
5672,1,0,23,0,-23
5673,0,0,62,0,-62
5674,1,0,75,0,-75
5675,1,0,82,0,-82
5676,1,0,107,0,-107
5677,1,0,32,0,-32
5678,1,1,16,2105,2089
5679,0,0,131,0,-131
5680,1,1,613,1408,795
5681,0,0,16,0,-16
5682,0,0,270,0,-270
5683,0,0,65,0,-65
5684,1,0,48,0,-48
5685,1,1,253,1514,1261
5686,0,0,82,0,-82
5687,1,0,26,0,-26
5688,0,0,166,0,-166
5689,0,0,119,0,-119
5690,1,0,6,0,-6
5691,0,0,71,0,-71
5692,1,0,78,0,-78
5693,0,0,54,0,-54
5694,0,0,38,0,-38
5695,0,0,2,0,-2
5696,1,1,93,1268,1175
5697,0,0,82,0,-82
5698,1,1,1191,1279,88
5699,1,0,223,0,-223
5700,1,1,122,1244,1122
5701,0,0,3,0,-3
5702,1,0,175,0,-175
5703,0,0,112,0,-112
5704,1,0,7,0,-7
5705,1,1,1308,1243,-65
5706,0,0,13,0,-13
5707,1,0,55,0,-55
5708,0,0,0,0,0
5709,0,0,1,0,-1
5710,1,0,21,0,-21
5711,1,0,102,0,-102
5712,0,0,6,0,-6
5713,0,0,29,0,-29
5714,0,0,27,0,-27
5715,0,0,233,0,-233
5716,1,1,227,1581,1354
5717,0,0,11,0,-11
5718,0,0,35,0,-35
5719,0,0,73,0,-73
5720,1,1,1012,2523,1511
5721,1,1,548,1493,945
5722,1,0,109,0,-109
5723,1,0,31,0,-31
5724,0,0,23,0,-23
5725,1,1,193,1909,1716
5726,0,0,20,0,-20
5727,1,1,811,1506,695
5728,1,0,12,0,-12
5729,1,1,72,1200,1128
5730,0,0,93,0,-93
5731,1,1,116,1640,1524
5732,1,0,24,0,-24
5733,1,1,133,1535,1402
5734,0,0,34,0,-34
5735,1,0,183,0,-183
5736,1,1,106,1624,1518
5737,1,0,286,0,-286
5738,1,0,29,0,-29
5739,0,0,23,0,-23
5740,1,1,170,1386,1216
5741,0,0,56,0,-56
5742,0,0,21,0,-21
5743,0,0,0,0,0
5744,1,0,18,0,-18
5745,0,0,36,0,-36
5746,0,0,144,0,-144
5747,0,0,49,0,-49
5748,1,0,17,0,-17
5749,1,1,308,1281,973
5750,1,0,101,0,-101
5751,1,1,179,1414,1235
5752,1,1,1108,1582,474
5753,0,0,28,0,-28
5754,1,1,266,1290,1024
5755,1,1,102,1311,1209
5756,0,0,74,0,-74
5757,1,1,465,1709,1244
5758,0,0,21,0,-21
5759,0,0,9,0,-9
5760,1,0,15,0,-15
5761,0,0,6,0,-6
5762,0,0,43,0,-43
5763,1,0,112,0,-112
5764,1,0,92,0,-92
5765,1,1,196,1263,1067
5766,1,0,191,0,-191
5767,1,0,29,0,-29
5768,1,0,37,0,-37
5769,1,1,120,1440,1320
5770,1,0,28,0,-28
5771,1,0,496,0,-496
5772,1,1,135,1418,1283
5773,1,0,9,0,-9
5774,0,0,19,0,-19
5775,1,0,133,0,-133
5776,0,0,36,0,-36
5777,0,0,46,0,-46
5778,1,1,935,1418,483
5779,0,0,50,0,-50
5780,1,1,77,1216,1139
5781,0,0,30,0,-30
5782,1,1,815,2089,1274
5783,1,0,55,0,-55
5784,1,0,22,0,-22
5785,1,1,91,1742,1651
5786,1,0,29,0,-29
5787,1,0,147,0,-147
5788,1,0,99,0,-99
5789,0,0,58,0,-58
5790,1,1,1163,1345,182
5791,0,0,31,0,-31
5792,1,0,84,0,-84
5793,0,0,2,0,-2
5794,1,1,502,1463,961
5795,1,0,114,0,-114
5796,0,0,29,0,-29
5797,1,1,53,1489,1436
5798,1,1,1637,1693,56
5799,1,0,22,0,-22
5800,1,1,515,1374,859
5801,1,0,18,0,-18
5802,1,0,2,0,-2
5803,0,0,13,0,-13
5804,0,0,11,0,-11
5805,1,0,33,0,-33
5806,0,0,9,0,-9
5807,1,1,924,1465,541
5808,0,0,1,0,-1
5809,1,1,484,1230,746
5810,1,1,351,1613,1262
5811,1,1,300,1235,935
5812,1,1,1479,1240,-239
5813,1,1,2378,4006,1628
5814,1,0,41,0,-41
5815,1,1,630,1352,722
5816,0,0,12,0,-12
5817,1,1,632,2164,1532
5818,1,1,831,2232,1401
5819,0,0,54,0,-54
5820,0,0,65,0,-65
5821,1,1,122,2137,2015
5822,1,0,129,0,-129
5823,1,1,278,1493,1215
5824,1,0,0,0,0
5825,0,0,41,0,-41
5826,1,1,320,1361,1041
5827,0,0,22,0,-22
5828,0,0,19,0,-19
5829,0,0,45,0,-45
5830,1,1,510,4602,4092
5831,1,0,89,0,-89
5832,0,0,18,0,-18
5833,1,1,515,1610,1095
5834,0,0,7,0,-7
5835,1,1,309,1444,1135
5836,0,0,309,0,-309
5837,0,0,158,0,-158
5838,0,0,1,0,-1
5839,0,0,52,0,-52
5840,1,0,6,0,-6
5841,1,0,67,0,-67
5842,0,0,11,0,-11
5843,1,0,13,0,-13
5844,1,1,1372,1260,-112
5845,1,1,383,1219,836
5846,1,0,12,0,-12
5847,0,0,36,0,-36
5848,0,0,55,0,-55
5849,0,0,40,0,-40
5850,0,0,32,0,-32
5851,1,0,70,0,-70
5852,0,0,14,0,-14
5853,0,0,5,0,-5
5854,1,1,349,1843,1494
5855,0,0,58,0,-58
5856,1,1,362,1380,1018
5857,1,0,12,0,-12
5858,1,1,595,1433,838
5859,1,1,684,1303,619
5860,1,1,596,1490,894
5861,0,0,27,0,-27
5862,1,1,912,1244,332
5863,0,0,10,0,-10
5864,1,0,131,0,-131
5865,1,1,736,1409,673
5866,0,0,3,0,-3
5867,1,0,56,0,-56
5868,1,0,94,0,-94
5869,1,0,10,0,-10
5870,1,1,88,1719,1631
5871,0,0,85,0,-85
5872,0,0,16,0,-16
5873,0,0,19,0,-19
5874,1,0,99,0,-99
5875,1,0,59,0,-59
5876,1,0,29,0,-29
5877,0,0,2,0,-2
5878,1,0,69,0,-69
5879,1,0,12,0,-12
5880,0,0,34,0,-34
5881,0,0,6,0,-6
5882,1,0,15,0,-15
5883,0,0,62,0,-62
5884,0,0,11,0,-11
5885,0,0,46,0,-46
5886,0,0,1,0,-1
5887,1,1,513,1427,914
5888,1,1,198,1200,1002
5889,1,0,55,0,-55
5890,1,1,194,1401,1207
5891,1,0,8,0,-8
5892,0,0,88,0,-88
5893,1,1,562,1224,662
5894,0,0,20,0,-20
5895,1,0,19,0,-19
5896,1,0,30,0,-30
5897,1,0,33,0,-33
5898,1,1,1798,1972,174
5899,1,0,17,0,-17
5900,0,0,52,0,-52
5901,0,0,24,0,-24
5902,1,1,350,1207,857
5903,1,0,7,0,-7
5904,1,0,80,0,-80
5905,1,1,359,1559,1200
5906,0,0,59,0,-59
5907,1,0,22,0,-22
5908,1,1,670,1994,1324
5909,1,0,305,0,-305
5910,1,1,714,1237,523
5911,1,1,289,1420,1131
5912,0,0,175,0,-175
5913,0,0,178,0,-178
5914,1,1,854,1241,387
5915,0,0,5,0,-5
5916,1,1,127,1649,1522
5917,1,1,68,1220,1152
5918,0,0,23,0,-23
5919,0,0,11,0,-11
5920,1,0,1,0,-1
5921,1,0,54,0,-54
5922,1,0,13,0,-13
5923,1,1,336,1303,967
5924,1,1,341,1593,1252
5925,0,0,89,0,-89
5926,1,0,47,0,-47
5927,1,0,22,0,-22
5928,1,1,654,1381,727
5929,0,0,2,0,-2
5930,0,0,7,0,-7
5931,0,0,124,0,-124
5932,0,0,22,0,-22
5933,1,0,1,0,-1
5934,1,0,104,0,-104
5935,1,0,24,0,-24
5936,1,1,645,1343,698
5937,0,0,45,0,-45
5938,1,0,32,0,-32
5939,0,0,55,0,-55
5940,0,0,61,0,-61
5941,1,0,14,0,-14
5942,1,1,177,1280,1103
5943,1,0,15,0,-15
5944,1,0,103,0,-103
5945,1,0,27,0,-27
5946,1,0,47,0,-47
5947,0,0,75,0,-75
5948,1,1,218,1481,1263
5949,1,1,71,1555,1484
5950,1,0,30,0,-30
5951,1,1,271,1203,932
5952,1,1,214,1236,1022
5953,1,1,112,3520,3408
5954,1,0,24,0,-24
5955,1,0,23,0,-23
5956,0,0,7,0,-7
5957,0,0,70,0,-70
5958,1,1,234,1369,1135
5959,0,0,22,0,-22
5960,0,0,6,0,-6
5961,1,1,293,4182,3889
5962,1,1,89,1243,1154
5963,1,1,43,2043,2000
5964,1,1,141,1389,1248
5965,1,1,451,1296,845
5966,0,0,97,0,-97
5967,0,0,15,0,-15
5968,0,0,29,0,-29
5969,1,0,90,0,-90
5970,0,0,66,0,-66
5971,0,0,74,0,-74
5972,1,0,74,0,-74
5973,1,1,155,1332,1177
5974,0,0,34,0,-34
5975,0,0,80,0,-80
5976,1,0,13,0,-13
5977,1,1,530,1318,788
5978,1,1,610,1258,648
5979,1,0,53,0,-53
5980,1,0,12,0,-12
5981,0,0,46,0,-46
5982,0,0,47,0,-47
5983,0,0,108,0,-108
5984,0,0,55,0,-55
5985,0,0,1,0,-1
5986,1,1,238,1574,1336
5987,0,0,19,0,-19
5988,1,0,24,0,-24
5989,1,1,84,1717,1633
5990,1,0,174,0,-174
5991,0,0,1,0,-1
5992,1,1,307,1497,1190
5993,0,0,103,0,-103
5994,0,0,70,0,-70
5995,0,0,13,0,-13
5996,1,1,323,1221,898
5997,1,1,831,1704,873
5998,1,1,123,1492,1369
5999,0,0,84,0,-84
6000,0,0,210,0,-210
6001,1,0,146,0,-146
6002,0,0,8,0,-8
6003,0,0,0,0,0
6004,1,1,81,1223,1142
6005,1,0,8,0,-8
6006,0,0,77,0,-77
6007,0,0,11,0,-11
6008,1,1,402,1992,1590
6009,1,1,91,1295,1204
6010,1,1,3014,1250,-1764
6011,0,0,81,0,-81
6012,1,1,640,1294,654
6013,0,0,22,0,-22
6014,1,0,9,0,-9
6015,1,1,319,2965,2646
6016,0,0,64,0,-64
6017,1,1,48,1248,1200
6018,1,1,216,3508,3292
6019,1,1,1033,1453,420
6020,1,0,6,0,-6
6021,1,0,34,0,-34
6022,1,1,776,2715,1939
6023,1,1,292,1462,1170
6024,0,0,9,0,-9
6025,0,0,83,0,-83
6026,1,0,52,0,-52
6027,0,0,13,0,-13
6028,1,1,118,1281,1163
6029,1,0,13,0,-13
6030,0,0,37,0,-37
6031,0,0,11,0,-11
6032,0,0,70,0,-70
6033,1,0,187,0,-187
6034,1,0,113,0,-113
6035,0,0,6,0,-6
6036,1,0,21,0,-21
6037,1,1,440,1247,807
6038,1,0,72,0,-72
6039,0,0,23,0,-23
6040,1,0,370,0,-370
6041,1,0,69,0,-69
6042,1,0,127,0,-127
6043,0,0,67,0,-67
6044,1,1,431,1535,1104
6045,0,0,3,0,-3
6046,0,0,16,0,-16
6047,1,1,478,1217,739
6048,1,1,106,1868,1762
6049,0,0,6,0,-6
6050,1,1,179,1392,1213
6051,1,1,128,1546,1418
6052,1,1,876,1322,446
6053,1,1,647,1859,1212
6054,0,0,56,0,-56
6055,1,1,634,1777,1143
6056,0,0,2,0,-2
6057,0,0,310,0,-310
6058,1,1,567,3933,3366
6059,1,0,194,0,-194
6060,1,1,615,1326,711
6061,1,1,560,1229,669
6062,0,0,16,0,-16
6063,1,0,90,0,-90
6064,0,0,58,0,-58
6065,1,1,327,2515,2188
6066,1,0,29,0,-29
6067,0,0,27,0,-27
6068,0,0,34,0,-34
6069,1,1,1959,1267,-692
6070,0,0,60,0,-60
6071,0,0,113,0,-113
6072,0,0,15,0,-15
6073,1,0,12,0,-12
6074,1,1,1452,1580,128
6075,1,0,38,0,-38
6076,0,0,0,0,0
6077,1,1,110,1212,1102
6078,1,1,96,1601,1505
6079,0,0,29,0,-29
6080,1,0,26,0,-26
6081,1,1,275,1403,1128
6082,1,0,17,0,-17
6083,1,1,108,1563,1455
6084,0,0,99,0,-99
6085,0,0,48,0,-48
6086,1,1,431,1442,1011
6087,1,0,3,0,-3
6088,0,0,10,0,-10
6089,1,0,72,0,-72
6090,0,0,31,0,-31
6091,1,0,78,0,-78
6092,1,1,474,1447,973
6093,0,0,42,0,-42
6094,0,0,0,0,0
6095,1,0,20,0,-20
6096,1,1,426,1437,1011
6097,0,0,53,0,-53
6098,1,0,106,0,-106
6099,1,1,250,1918,1668
6100,0,0,6,0,-6
6101,0,0,103,0,-103
6102,1,1,44,1210,1166
6103,1,1,351,2118,1767
6104,1,0,32,0,-32
6105,0,0,76,0,-76
6106,1,1,876,1360,484
6107,1,0,29,0,-29
6108,1,0,80,0,-80
6109,0,0,11,0,-11
6110,1,1,849,1493,644
6111,0,0,1,0,-1
6112,0,0,15,0,-15
6113,1,1,869,1321,452
6114,1,0,10,0,-10
6115,1,0,98,0,-98
6116,0,0,26,0,-26
6117,0,0,114,0,-114
6118,1,0,12,0,-12
6119,0,0,30,0,-30
6120,1,1,634,1202,568
6121,1,1,2048,1283,-765
6122,0,0,21,0,-21
6123,1,0,57,0,-57
6124,1,0,19,0,-19
6125,1,1,492,1705,1213
6126,0,0,74,0,-74
6127,0,0,45,0,-45
6128,1,1,137,1217,1080
6129,0,0,115,0,-115
6130,0,0,67,0,-67
6131,1,1,553,1642,1089
6132,1,0,42,0,-42
6133,1,0,20,0,-20
6134,0,0,24,0,-24
6135,0,0,81,0,-81
6136,0,0,139,0,-139
6137,1,1,231,1799,1568
6138,0,0,0,0,0
6139,0,0,83,0,-83
6140,1,1,44,1339,1295
6141,0,0,30,0,-30
6142,1,1,375,1565,1190
6143,1,0,13,0,-13
6144,1,1,554,1510,956
6145,1,1,103,1223,1120
6146,1,1,730,1392,662
6147,1,0,19,0,-19
6148,0,0,76,0,-76
6149,1,1,193,1240,1047
6150,0,0,38,0,-38
6151,1,0,1,0,-1
6152,1,1,303,1519,1216
6153,0,0,9,0,-9
6154,0,0,20,0,-20
6155,0,0,16,0,-16
6156,0,0,73,0,-73
6157,1,0,75,0,-75
6158,0,0,2,0,-2
6159,0,0,90,0,-90
6160,0,0,25,0,-25
6161,1,1,179,1404,1225
6162,1,1,382,1213,831
6163,0,0,102,0,-102
6164,1,1,750,1391,641
6165,1,1,919,1413,494
6166,1,1,1542,1520,-22
6167,0,0,15,0,-15
6168,0,0,105,0,-105
6169,0,0,38,0,-38
6170,1,1,881,1320,439
6171,0,0,5,0,-5
6172,0,0,6,0,-6
6173,1,0,27,0,-27
6174,1,0,128,0,-128
6175,1,0,85,0,-85
6176,0,0,52,0,-52
6177,0,0,137,0,-137
6178,1,0,171,0,-171
6179,1,1,137,1569,1432
6180,1,0,39,0,-39
6181,1,1,276,1205,929
6182,1,0,33,0,-33
6183,0,0,99,0,-99
6184,1,1,1894,1443,-451
6185,1,0,55,0,-55
6186,1,0,75,0,-75
6187,1,0,87,0,-87
6188,0,0,30,0,-30
6189,0,0,231,0,-231
6190,1,0,24,0,-24
6191,0,0,162,0,-162
6192,0,0,6,0,-6
6193,0,0,112,0,-112
6194,0,0,18,0,-18
6195,0,0,6,0,-6
6196,0,0,0,0,0
6197,1,0,45,0,-45
6198,1,0,7,0,-7
6199,0,0,13,0,-13
6200,1,0,2,0,-2
6201,1,0,69,0,-69
6202,1,0,23,0,-23
6203,1,0,126,0,-126
6204,0,0,27,0,-27
6205,0,0,99,0,-99
6206,1,1,420,1312,892
6207,0,0,115,0,-115
6208,1,0,71,0,-71
6209,1,0,69,0,-69
6210,0,0,48,0,-48
6211,0,0,57,0,-57
6212,1,0,24,0,-24
6213,0,0,63,0,-63
6214,0,0,3,0,-3
6215,0,0,85,0,-85
6216,1,0,35,0,-35
6217,0,0,100,0,-100
6218,1,0,44,0,-44
6219,0,0,11,0,-11
6220,0,0,130,0,-130
6221,1,1,100,1212,1112
6222,0,0,21,0,-21
6223,1,1,864,1373,509
6224,1,0,107,0,-107
6225,1,1,191,2152,1961
6226,1,1,114,2066,1952
6227,0,0,143,0,-143
6228,0,0,10,0,-10
6229,1,0,5,0,-5
6230,1,0,62,0,-62
6231,1,1,1101,1575,474
6232,0,0,35,0,-35
6233,1,1,492,2160,1668
6234,1,1,117,1418,1301
6235,1,0,190,0,-190
6236,1,1,1825,2915,1090
6237,1,1,1569,1521,-48
6238,1,0,47,0,-47
6239,1,1,369,1351,982
6240,0,0,7,0,-7
6241,1,1,184,1243,1059
6242,1,1,365,1481,1116
6243,1,1,1120,1517,397
6244,0,0,16,0,-16
6245,1,0,46,0,-46
6246,0,0,90,0,-90
6247,1,1,89,1631,1542
6248,1,0,8,0,-8
6249,1,0,18,0,-18
6250,1,1,255,1231,976
6251,0,0,66,0,-66
6252,0,0,109,0,-109
6253,0,0,83,0,-83
6254,0,0,161,0,-161
6255,0,0,93,0,-93
6256,0,0,53,0,-53
6257,0,0,49,0,-49
6258,0,0,92,0,-92
6259,1,0,43,0,-43
6260,0,0,142,0,-142
6261,0,0,14,0,-14
6262,1,1,454,2381,1927
6263,0,0,55,0,-55
6264,0,0,67,0,-67
6265,1,1,444,1342,898
6266,1,0,219,0,-219
6267,0,0,11,0,-11
6268,1,1,49,1666,1617
6269,1,0,26,0,-26
6270,0,0,84,0,-84
6271,0,0,86,0,-86
6272,1,1,523,1221,698
6273,0,0,65,0,-65
6274,1,0,68,0,-68
6275,0,0,27,0,-27
6276,1,1,151,1235,1084
6277,0,0,81,0,-81
6278,0,0,1,0,-1
6279,0,0,83,0,-83
6280,1,0,77,0,-77
6281,1,0,27,0,-27
6282,1,0,46,0,-46
6283,1,0,27,0,-27
6284,1,0,19,0,-19
6285,1,1,1774,1326,-448
6286,1,1,304,2786,2482
6287,1,1,107,1675,1568
6288,1,1,1788,1232,-556
6289,1,1,117,1935,1818
6290,0,0,83,0,-83
6291,1,0,16,0,-16
6292,1,1,229,1297,1068
6293,1,1,513,1729,1216
6294,1,0,84,0,-84
6295,0,0,32,0,-32
6296,1,0,12,0,-12
6297,1,1,84,1286,1202
6298,0,0,7,0,-7
6299,0,0,21,0,-21
6300,1,1,325,1586,1261
6301,0,0,30,0,-30
6302,1,0,20,0,-20
6303,0,0,119,0,-119
6304,0,0,0,0,0
6305,0,0,47,0,-47
6306,1,1,390,1836,1446
6307,1,0,2,0,-2
6308,0,0,54,0,-54
6309,0,0,76,0,-76
6310,1,1,184,2243,2059
6311,1,1,236,1289,1053
6312,1,1,142,1500,1358
6313,0,0,1,0,-1
6314,1,1,125,1711,1586
6315,1,0,44,0,-44
6316,0,0,5,0,-5
6317,0,0,15,0,-15
6318,1,0,11,0,-11
6319,1,0,19,0,-19
6320,1,1,51,1474,1423
6321,0,0,75,0,-75
6322,0,0,65,0,-65
6323,1,0,52,0,-52
6324,1,1,61,1227,1166
6325,1,1,347,1339,992
6326,1,1,94,1247,1153
6327,1,0,15,0,-15
6328,0,0,21,0,-21
6329,1,0,18,0,-18
6330,0,0,27,0,-27
6331,1,1,416,1372,956
6332,0,0,25,0,-25
6333,1,1,1459,1432,-27
6334,1,1,416,1207,791
6335,1,1,106,1273,1167
6336,1,0,6,0,-6
6337,1,0,15,0,-15
6338,1,0,1,0,-1
6339,1,1,631,1357,726
6340,1,1,156,1340,1184
6341,1,1,315,1278,963
6342,1,1,728,1339,611
6343,0,0,60,0,-60
6344,0,0,241,0,-241
6345,0,0,27,0,-27
6346,0,0,20,0,-20
6347,1,1,144,1209,1065
6348,0,0,10,0,-10
6349,1,0,41,0,-41
6350,1,0,44,0,-44
6351,1,1,62,1226,1164
6352,1,0,16,0,-16
6353,1,1,515,1233,718
6354,0,0,30,0,-30
6355,0,0,24,0,-24
6356,0,0,48,0,-48
6357,0,0,61,0,-61
6358,1,0,92,0,-92
6359,0,0,9,0,-9
6360,0,0,53,0,-53
6361,0,0,17,0,-17
6362,0,0,34,0,-34
6363,0,0,28,0,-28
6364,1,1,545,1904,1359
6365,0,0,46,0,-46
6366,1,0,17,0,-17
6367,1,0,51,0,-51
6368,1,1,599,2483,1884
6369,0,0,128,0,-128
6370,1,0,9,0,-9
6371,1,0,4,0,-4
6372,0,0,32,0,-32
6373,1,1,282,1836,1554
6374,0,0,10,0,-10
6375,0,0,52,0,-52
6376,0,0,36,0,-36
6377,1,1,168,1327,1159
6378,1,1,103,1384,1281
6379,0,0,14,0,-14
6380,1,1,182,1711,1529
6381,1,1,236,1213,977
6382,1,1,435,1337,902
6383,1,1,533,1806,1273
6384,0,0,2,0,-2
6385,1,0,27,0,-27
6386,1,1,381,2012,1631
6387,1,1,1044,2227,1183
6388,0,0,25,0,-25
6389,0,0,127,0,-127
6390,1,1,74,1588,1514
6391,1,0,24,0,-24
6392,1,0,4,0,-4
6393,1,0,80,0,-80
6394,1,1,869,1383,514
6395,1,0,90,0,-90
6396,1,1,419,1291,872
6397,1,0,93,0,-93
6398,0,0,83,0,-83
6399,1,1,388,1306,918
6400,0,0,36,0,-36
6401,0,0,49,0,-49
6402,1,0,101,0,-101
6403,1,0,30,0,-30
6404,1,1,581,2372,1791
6405,1,0,0,0,0
6406,0,0,50,0,-50
6407,1,1,74,1736,1662
6408,1,1,368,1290,922
6409,1,1,720,1236,516
6410,1,0,18,0,-18
6411,1,1,1576,1405,-171
6412,1,0,61,0,-61
6413,0,0,26,0,-26
6414,0,0,46,0,-46
6415,0,0,7,0,-7
6416,1,0,16,0,-16
6417,0,0,83,0,-83
6418,1,0,96,0,-96
6419,1,1,326,1580,1254
6420,0,0,38,0,-38
6421,0,0,49,0,-49
6422,1,0,48,0,-48
6423,1,0,23,0,-23
6424,1,0,191,0,-191
6425,0,0,60,0,-60
6426,0,0,63,0,-63
6427,1,0,24,0,-24
6428,1,0,69,0,-69
6429,0,0,96,0,-96
6430,0,0,18,0,-18
6431,1,1,467,1357,890
6432,0,0,27,0,-27
6433,1,1,254,1887,1633
6434,0,0,35,0,-35
6435,0,0,78,0,-78
6436,0,0,53,0,-53
6437,1,1,258,1319,1061
6438,1,1,304,1494,1190
6439,1,0,56,0,-56
6440,1,0,183,0,-183
6441,0,0,100,0,-100
6442,0,0,54,0,-54
6443,1,1,363,1253,890
6444,0,0,75,0,-75
6445,0,0,90,0,-90
6446,1,0,47,0,-47
6447,1,0,71,0,-71
6448,0,0,23,0,-23
6449,1,0,88,0,-88
6450,1,1,686,1841,1155
6451,1,0,37,0,-37
6452,0,0,65,0,-65
6453,1,1,219,1349,1130
6454,0,0,27,0,-27
6455,1,1,441,1502,1061
6456,1,1,480,1234,754
6457,0,0,3,0,-3
6458,0,0,46,0,-46
6459,0,0,28,0,-28
6460,0,0,12,0,-12
6461,1,1,897,1295,398
6462,0,0,32,0,-32
6463,0,0,90,0,-90
6464,0,0,133,0,-133
6465,0,0,171,0,-171
6466,1,1,97,2059,1962
6467,1,1,240,1560,1320
6468,1,1,687,1476,789
6469,1,0,18,0,-18
6470,0,0,51,0,-51
6471,0,0,12,0,-12
6472,1,0,22,0,-22
6473,1,1,319,1241,922
6474,1,0,36,0,-36
6475,1,1,572,1547,975
6476,1,0,163,0,-163
6477,0,0,116,0,-116
6478,0,0,5,0,-5
6479,1,0,17,0,-17
6480,1,1,122,1597,1475
6481,0,0,10,0,-10
6482,1,0,13,0,-13
6483,1,1,192,2364,2172
6484,0,0,22,0,-22
6485,1,1,383,1560,1177
6486,0,0,22,0,-22
6487,0,0,102,0,-102
6488,1,0,0,0,0
6489,1,0,57,0,-57
6490,0,0,48,0,-48
6491,1,0,31,0,-31
6492,0,0,15,0,-15
6493,1,1,596,1337,741
6494,1,0,43,0,-43
6495,1,1,97,1573,1476
6496,1,1,327,1407,1080
6497,0,0,50,0,-50
6498,1,1,858,1282,424
6499,1,0,59,0,-59
6500,0,0,7,0,-7
6501,0,0,2,0,-2
6502,0,0,81,0,-81
6503,1,0,17,0,-17
6504,1,0,1,0,-1
6505,0,0,8,0,-8
6506,1,0,4,0,-4
6507,0,0,48,0,-48
6508,1,1,126,1981,1855
6509,0,0,4,0,-4
6510,1,1,103,1329,1226
6511,1,1,245,1204,959
6512,0,0,78,0,-78
6513,0,0,92,0,-92
6514,1,0,47,0,-47
6515,1,0,1,0,-1
6516,0,0,101,0,-101
6517,1,1,30,1400,1370
6518,1,0,38,0,-38
6519,1,1,148,1600,1452
6520,0,0,124,0,-124
6521,1,0,43,0,-43
6522,0,0,71,0,-71
6523,1,1,329,1213,884
6524,0,0,5,0,-5
6525,0,0,74,0,-74
6526,1,1,628,1207,579
6527,0,0,16,0,-16
6528,1,1,86,2697,2611
6529,1,0,130,0,-130
6530,0,0,29,0,-29
6531,0,0,55,0,-55
6532,1,0,15,0,-15
6533,0,0,25,0,-25
6534,1,1,451,2513,2062
6535,1,1,342,1485,1143
6536,1,0,0,0,0
6537,1,1,908,1464,556
6538,1,1,760,2709,1949
6539,1,1,428,1642,1214
6540,1,0,31,0,-31
6541,0,0,72,0,-72
6542,1,1,142,1534,1392
6543,0,0,7,0,-7
6544,1,1,121,1443,1322
6545,1,1,204,1214,1010
6546,0,0,67,0,-67
6547,1,1,413,1545,1132
6548,0,0,12,0,-12
6549,1,0,108,0,-108
6550,0,0,3,0,-3
6551,1,1,362,1243,881
6552,0,0,0,0,0
6553,0,0,27,0,-27
6554,1,1,168,1390,1222
6555,1,0,18,0,-18
6556,0,0,94,0,-94
6557,1,1,783,1437,654
6558,1,1,455,1649,1194
6559,1,1,366,1827,1461
6560,1,1,630,1238,608
6561,0,0,71,0,-71
6562,0,0,114,0,-114
6563,1,0,13,0,-13
6564,0,0,169,0,-169
6565,1,0,35,0,-35
6566,1,0,0,0,0
6567,0,0,50,0,-50
6568,0,0,13,0,-13
6569,1,1,1768,1549,-219
6570,0,0,66,0,-66
6571,0,0,2,0,-2
6572,1,0,113,0,-113
6573,0,0,11,0,-11
6574,1,1,1232,1205,-27
6575,1,0,66,0,-66
6576,0,0,3,0,-3
6577,1,1,789,1298,509
6578,0,0,11,0,-11
6579,1,0,19,0,-19
6580,0,0,119,0,-119
6581,1,0,85,0,-85
6582,1,0,40,0,-40
6583,1,0,9,0,-9
6584,1,1,49,1772,1723
6585,0,0,92,0,-92
6586,0,0,107,0,-107
6587,1,1,855,1268,413
6588,1,0,224,0,-224
6589,0,0,14,0,-14
6590,0,0,16,0,-16
6591,0,0,5,0,-5
6592,0,0,24,0,-24
6593,1,1,210,1235,1025
6594,1,0,3,0,-3
6595,1,1,347,1878,1531
6596,1,0,5,0,-5
6597,0,0,11,0,-11
6598,0,0,33,0,-33
6599,0,0,126,0,-126
6600,1,1,217,1370,1153
6601,0,0,263,0,-263
6602,1,0,38,0,-38
6603,1,1,159,4341,4182
6604,1,1,536,1212,676
6605,0,0,97,0,-97
6606,1,0,74,0,-74
6607,0,0,145,0,-145
6608,0,0,29,0,-29
6609,1,1,250,1560,1310
6610,0,0,284,0,-284
6611,0,0,12,0,-12
6612,0,0,122,0,-122
6613,0,0,211,0,-211
6614,1,0,12,0,-12
6615,0,0,8,0,-8
6616,1,1,75,1391,1316
6617,1,1,43,1255,1212
6618,1,0,58,0,-58
6619,1,0,28,0,-28
6620,1,1,1019,1616,597
6621,1,1,164,1469,1305
6622,1,1,1440,1226,-214
6623,0,0,17,0,-17
6624,1,0,59,0,-59
6625,1,0,45,0,-45
6626,1,1,228,1786,1558
6627,0,0,54,0,-54
6628,0,0,35,0,-35
6629,1,1,292,1206,914
6630,1,0,20,0,-20
6631,1,0,9,0,-9
6632,1,0,5,0,-5
6633,0,0,25,0,-25
6634,1,1,255,1346,1091
6635,1,1,753,1545,792
6636,1,1,614,1212,598
6637,1,1,1156,1342,186
6638,1,0,82,0,-82
6639,1,1,349,2593,2244
6640,0,0,54,0,-54
6641,1,1,324,1696,1372
6642,0,0,24,0,-24
6643,1,1,193,2087,1894
6644,0,0,0,0,0
6645,0,0,94,0,-94
6646,1,1,15,1459,1444
6647,0,0,218,0,-218
6648,1,1,255,1441,1186
6649,1,0,4,0,-4
6650,0,0,56,0,-56
6651,1,1,778,1780,1002
6652,1,0,20,0,-20
6653,1,1,290,1781,1491
6654,1,0,73,0,-73
6655,0,0,119,0,-119
6656,1,0,8,0,-8
6657,1,1,15,2464,2449
6658,1,1,805,1298,493
6659,1,1,1274,1558,284
6660,0,0,150,0,-150
6661,0,0,28,0,-28
6662,0,0,24,0,-24
6663,1,1,620,1580,960
6664,0,0,20,0,-20
6665,1,1,554,1377,823
6666,1,0,28,0,-28
6667,0,0,29,0,-29
6668,0,0,62,0,-62
6669,1,1,497,1335,838
6670,0,0,57,0,-57
6671,0,0,4,0,-4
6672,1,0,25,0,-25
6673,0,0,31,0,-31
6674,0,0,8,0,-8
6675,0,0,65,0,-65
6676,0,0,117,0,-117
6677,1,0,50,0,-50
6678,1,0,2,0,-2
6679,1,1,172,3909,3737
6680,1,0,182,0,-182
6681,1,1,1333,2382,1049
6682,1,1,186,1327,1141
6683,1,1,472,1575,1103
6684,0,0,55,0,-55
6685,1,1,120,1377,1257
6686,1,1,193,1431,1238
6687,0,0,30,0,-30
6688,1,0,4,0,-4
6689,1,0,8,0,-8
6690,0,0,116,0,-116
6691,1,0,22,0,-22
6692,0,0,89,0,-89
6693,1,1,487,2239,1752
6694,1,1,567,1286,719
6695,1,0,28,0,-28
6696,1,1,389,1358,969
6697,1,1,372,1657,1285
6698,1,0,91,0,-91
6699,1,1,43,1410,1367
6700,1,1,529,1330,801
6701,1,0,1,0,-1
6702,1,1,269,1864,1595
6703,1,0,44,0,-44
6704,0,0,119,0,-119
6705,1,1,1083,1304,221
6706,0,0,48,0,-48
6707,0,0,1,0,-1
6708,1,0,107,0,-107
6709,1,1,793,1442,649
6710,1,0,4,0,-4
6711,1,1,1313,1536,223
6712,0,0,1,0,-1
6713,1,0,12,0,-12
6714,1,1,203,1669,1466
6715,1,0,23,0,-23
6716,0,0,79,0,-79
6717,1,1,1154,1447,293
6718,1,1,325,1222,897
6719,0,0,4,0,-4
6720,1,0,51,0,-51
6721,1,0,23,0,-23
6722,1,1,1200,1651,451
6723,1,1,48,1213,1165
6724,1,1,502,1599,1097
6725,1,0,23,0,-23
6726,0,0,31,0,-31
6727,0,0,16,0,-16
6728,1,1,910,1228,318
6729,0,0,160,0,-160
6730,0,0,62,0,-62
6731,1,1,48,1301,1253
6732,0,0,125,0,-125
6733,1,0,56,0,-56
6734,1,0,59,0,-59
6735,0,0,32,0,-32
6736,0,0,12,0,-12
6737,1,0,55,0,-55
6738,1,1,531,1770,1239
6739,0,0,144,0,-144
6740,1,1,175,1414,1239
6741,1,1,303,1217,914
6742,0,0,67,0,-67
6743,1,0,38,0,-38
6744,1,1,227,1476,1249
6745,1,1,483,1273,790
6746,0,0,129,0,-129
6747,1,0,39,0,-39
6748,1,0,59,0,-59
6749,0,0,83,0,-83
6750,0,0,225,0,-225
6751,0,0,85,0,-85
6752,1,0,25,0,-25
6753,1,1,207,1358,1151
6754,0,0,33,0,-33
6755,1,0,101,0,-101
6756,0,0,75,0,-75
6757,1,1,2529,1290,-1239
6758,1,0,132,0,-132
6759,1,0,46,0,-46
6760,1,1,300,1207,907
6761,1,0,0,0,0
6762,1,1,631,1250,619
6763,1,0,40,0,-40
6764,0,0,93,0,-93
6765,0,0,14,0,-14
6766,1,0,40,0,-40
6767,1,0,3,0,-3
6768,0,0,10,0,-10
6769,1,0,70,0,-70
6770,1,1,492,1208,716
6771,0,0,13,0,-13
6772,1,0,13,0,-13
6773,1,0,13,0,-13
6774,1,1,338,1631,1293
6775,0,0,28,0,-28
6776,0,0,33,0,-33
6777,1,1,95,1212,1117
6778,0,0,31,0,-31
6779,1,1,88,1311,1223
6780,0,0,1,0,-1
6781,0,0,58,0,-58
6782,1,0,54,0,-54
6783,1,0,14,0,-14
6784,0,0,117,0,-117
6785,1,0,16,0,-16
6786,0,0,45,0,-45
6787,0,0,33,0,-33
6788,0,0,35,0,-35
6789,0,0,187,0,-187
6790,0,0,46,0,-46
6791,0,0,28,0,-28
6792,1,0,80,0,-80
6793,1,0,0,0,0
6794,1,1,122,1262,1140
6795,1,0,195,0,-195
6796,1,1,449,1222,773
6797,1,0,36,0,-36
6798,0,0,29,0,-29
6799,1,1,482,1206,724
6800,1,0,66,0,-66
6801,1,0,10,0,-10
6802,0,0,11,0,-11
6803,1,1,497,1267,770
6804,1,0,27,0,-27
6805,1,1,288,1656,1368
6806,0,0,24,0,-24
6807,1,1,105,2326,2221
6808,1,1,792,1293,501
6809,1,1,780,1248,468
6810,1,0,7,0,-7
6811,1,1,75,1741,1666
6812,1,0,7,0,-7
6813,0,0,14,0,-14
6814,1,0,193,0,-193
6815,1,1,768,1588,820
6816,0,0,100,0,-100
6817,1,0,161,0,-161
6818,1,0,310,0,-310
6819,1,0,110,0,-110
6820,1,0,88,0,-88
6821,1,1,823,1264,441
6822,0,0,16,0,-16
6823,1,1,246,1507,1261
6824,1,0,54,0,-54
6825,1,1,183,4481,4298
6826,0,0,13,0,-13
6827,0,0,39,0,-39
6828,1,1,28,1649,1621
6829,0,0,36,0,-36
6830,1,1,272,1772,1500
6831,1,0,63,0,-63
6832,1,0,16,0,-16
6833,1,0,190,0,-190
6834,1,0,17,0,-17
6835,1,1,245,1578,1333
6836,0,0,65,0,-65
6837,1,0,16,0,-16
6838,0,0,150,0,-150
6839,0,0,54,0,-54
6840,1,0,27,0,-27
6841,1,1,344,1239,895
6842,0,0,12,0,-12
6843,1,1,305,1245,940
6844,0,0,22,0,-22
6845,0,0,0,0,0
6846,0,0,4,0,-4
6847,0,0,7,0,-7
6848,1,1,101,1209,1108
6849,1,0,188,0,-188
6850,1,0,52,0,-52
6851,0,0,2,0,-2
6852,1,0,132,0,-132
6853,1,0,66,0,-66
6854,0,0,3,0,-3
6855,1,0,7,0,-7
6856,0,0,225,0,-225
6857,1,0,1,0,-1
6858,0,0,8,0,-8
6859,1,0,47,0,-47
6860,1,0,41,0,-41
6861,1,0,93,0,-93
6862,0,0,13,0,-13
6863,1,0,63,0,-63
6864,1,1,154,1361,1207
6865,1,0,104,0,-104
6866,0,0,344,0,-344
6867,0,0,31,0,-31
6868,0,0,29,0,-29
6869,1,0,27,0,-27
6870,1,0,111,0,-111
6871,1,0,113,0,-113
6872,0,0,48,0,-48
6873,0,0,146,0,-146
6874,0,0,113,0,-113
6875,0,0,36,0,-36
6876,0,0,176,0,-176
6877,1,0,63,0,-63
6878,1,1,378,1748,1370
6879,1,0,40,0,-40
6880,1,0,58,0,-58
6881,1,0,36,0,-36
6882,0,0,4,0,-4
6883,0,0,45,0,-45
6884,1,0,8,0,-8
6885,0,0,9,0,-9
6886,0,0,38,0,-38
6887,1,1,543,1454,911
6888,0,0,43,0,-43
6889,1,0,185,0,-185
6890,1,1,746,1898,1152
6891,1,0,25,0,-25
6892,1,1,577,1256,679
6893,0,0,45,0,-45
6894,1,0,59,0,-59
6895,0,0,41,0,-41
6896,1,1,378,1580,1202
6897,1,0,69,0,-69
6898,1,1,449,1506,1057
6899,1,0,17,0,-17
6900,1,0,22,0,-22
6901,0,0,13,0,-13
6902,0,0,13,0,-13
6903,1,1,1441,1376,-65
6904,1,0,60,0,-60
6905,0,0,22,0,-22
6906,0,0,1,0,-1
6907,1,0,99,0,-99
6908,1,0,3,0,-3
6909,0,0,70,0,-70
6910,1,0,24,0,-24
6911,0,0,36,0,-36
6912,0,0,6,0,-6
6913,1,1,785,1928,1143
6914,0,0,98,0,-98
6915,0,0,9,0,-9
6916,1,0,45,0,-45
6917,1,1,627,1611,984
6918,1,1,247,1261,1014
6919,1,1,137,1415,1278
6920,1,0,16,0,-16
6921,1,1,748,1743,995
6922,0,0,22,0,-22
6923,1,0,75,0,-75
6924,0,0,34,0,-34
6925,0,0,72,0,-72
6926,1,0,4,0,-4
6927,0,0,36,0,-36
6928,1,0,6,0,-6
6929,1,1,338,1707,1369
6930,0,0,61,0,-61
6931,1,0,18,0,-18
6932,1,0,123,0,-123
6933,0,0,75,0,-75
6934,1,1,92,1489,1397
6935,1,0,42,0,-42
6936,1,1,137,1213,1076
6937,1,1,346,1555,1209
6938,1,1,606,1563,957
6939,1,0,92,0,-92
6940,0,0,83,0,-83
6941,1,1,192,1502,1310
6942,1,0,47,0,-47
6943,0,0,2,0,-2
6944,0,0,13,0,-13
6945,0,0,37,0,-37
6946,1,1,1174,1231,57
6947,1,0,47,0,-47
6948,1,0,31,0,-31
6949,1,0,135,0,-135
6950,1,1,205,1254,1049
6951,1,1,20,1436,1416
6952,1,0,14,0,-14
6953,1,1,746,1621,875
6954,1,1,139,1458,1319
6955,0,0,98,0,-98
6956,1,1,464,1992,1528
6957,1,1,415,1576,1161
6958,1,0,1,0,-1
6959,0,0,46,0,-46
6960,0,0,29,0,-29
6961,1,0,21,0,-21
6962,1,0,22,0,-22
6963,1,1,237,1319,1082
6964,0,0,34,0,-34
6965,1,0,43,0,-43
6966,0,0,122,0,-122
6967,0,0,111,0,-111
6968,1,0,90,0,-90
6969,1,0,66,0,-66
6970,1,0,67,0,-67
6971,1,0,36,0,-36
6972,0,0,13,0,-13
6973,1,1,290,1274,984
6974,1,1,46,2964,2918
6975,1,1,751,1295,544
6976,1,1,460,1575,1115
6977,1,0,15,0,-15
6978,1,1,135,1399,1264
6979,0,0,0,0,0
6980,1,1,62,1592,1530
6981,0,0,71,0,-71
6982,1,0,31,0,-31
6983,0,0,13,0,-13
6984,0,0,8,0,-8
6985,1,1,321,1699,1378
6986,0,0,49,0,-49
6987,0,0,33,0,-33
6988,1,1,313,2306,1993
6989,1,0,1,0,-1
6990,1,1,492,1684,1192
6991,1,0,39,0,-39
6992,1,1,556,1218,662
6993,1,0,97,0,-97
6994,0,0,86,0,-86
6995,1,0,9,0,-9
6996,0,0,36,0,-36
6997,0,0,68,0,-68
6998,1,1,187,1475,1288
6999,1,0,52,0,-52
7000,1,1,639,1780,1141
7001,0,0,110,0,-110
7002,1,0,18,0,-18
7003,1,1,602,1260,658
7004,0,0,24,0,-24
7005,1,0,57,0,-57
7006,0,0,51,0,-51
7007,0,0,13,0,-13
7008,1,0,6,0,-6
7009,1,0,18,0,-18
7010,1,1,95,1328,1233
7011,1,1,103,1376,1273
7012,1,1,191,1546,1355
7013,0,0,3,0,-3
7014,1,0,28,0,-28
7015,1,0,14,0,-14
7016,1,0,21,0,-21
7017,1,0,31,0,-31
7018,1,0,14,0,-14
7019,1,0,44,0,-44
7020,1,1,1267,1279,12
7021,0,0,17,0,-17
7022,1,0,17,0,-17
7023,1,1,468,1243,775
7024,1,0,99,0,-99
7025,0,0,13,0,-13
7026,1,1,629,1875,1246
7027,0,0,20,0,-20
7028,0,0,68,0,-68
7029,1,0,56,0,-56
7030,1,0,51,0,-51
7031,0,0,7,0,-7
7032,0,0,23,0,-23
7033,0,0,1,0,-1
7034,1,0,10,0,-10
7035,1,0,41,0,-41
7036,0,0,133,0,-133
7037,0,0,9,0,-9
7038,1,1,530,1203,673
7039,0,0,17,0,-17
7040,0,0,40,0,-40
7041,1,0,158,0,-158
7042,0,0,10,0,-10
7043,0,0,0,0,0
7044,1,1,606,1814,1208
7045,1,1,417,1520,1103
7046,0,0,119,0,-119
7047,1,1,99,1776,1677
7048,1,0,11,0,-11
7049,0,0,156,0,-156
7050,0,0,135,0,-135
7051,1,1,209,1689,1480
7052,1,0,28,0,-28
7053,1,1,178,1962,1784
7054,1,1,113,1711,1598
7055,0,0,47,0,-47
7056,1,1,99,1249,1150
7057,0,0,7,0,-7
7058,1,1,349,2205,1856
7059,1,1,809,2811,2002
7060,1,0,33,0,-33
7061,1,0,55,0,-55
7062,0,0,0,0,0
7063,0,0,15,0,-15
7064,1,0,88,0,-88
7065,0,0,39,0,-39
7066,1,0,97,0,-97
7067,1,1,295,2488,2193
7068,0,0,6,0,-6
7069,1,0,9,0,-9
7070,0,0,12,0,-12
7071,1,1,911,1212,301
7072,0,0,63,0,-63
7073,0,0,102,0,-102
7074,0,0,17,0,-17
7075,1,1,287,1999,1712
7076,0,0,114,0,-114
7077,0,0,40,0,-40
7078,1,0,18,0,-18
7079,1,0,69,0,-69
7080,0,0,41,0,-41
7081,0,0,53,0,-53
7082,1,0,9,0,-9
7083,0,0,17,0,-17
7084,0,0,0,0,0
7085,0,0,6,0,-6
7086,1,0,13,0,-13
7087,0,0,9,0,-9
7088,1,1,1070,1202,132
7089,1,1,124,1357,1233
7090,0,0,18,0,-18
7091,0,0,114,0,-114
7092,1,0,49,0,-49
7093,1,0,24,0,-24
7094,0,0,95,0,-95
7095,0,0,29,0,-29
7096,1,0,40,0,-40
7097,0,0,68,0,-68
7098,0,0,34,0,-34
7099,0,0,40,0,-40
7100,1,0,25,0,-25
7101,1,0,38,0,-38
7102,1,1,426,1597,1171
7103,1,0,111,0,-111
7104,1,1,498,1833,1335
7105,0,0,6,0,-6
7106,0,0,29,0,-29
7107,1,1,96,1314,1218
7108,1,1,1051,1291,240
7109,0,0,2,0,-2
7110,1,0,67,0,-67
7111,1,0,17,0,-17
7112,0,0,152,0,-152
7113,0,0,50,0,-50
7114,1,1,1622,1384,-238
7115,1,1,936,1251,315
7116,0,0,93,0,-93
7117,1,1,183,2114,1931
7118,1,0,29,0,-29
7119,1,0,53,0,-53
7120,1,1,373,1751,1378
7121,1,0,36,0,-36
7122,1,0,121,0,-121
7123,1,1,173,1303,1130
7124,1,0,7,0,-7
7125,1,0,33,0,-33
7126,1,1,737,1312,575
7127,1,1,557,1335,778
7128,0,0,5,0,-5
7129,0,0,29,0,-29
7130,1,0,30,0,-30
7131,0,0,112,0,-112
7132,1,0,39,0,-39
7133,0,0,16,0,-16
7134,1,0,70,0,-70
7135,1,1,204,1231,1027
7136,1,0,33,0,-33
7137,1,0,8,0,-8
7138,0,0,25,0,-25
7139,1,1,1490,1460,-30
7140,0,0,3,0,-3
7141,0,0,59,0,-59
7142,1,0,36,0,-36
7143,0,0,19,0,-19
7144,1,1,1526,1201,-325
7145,0,0,256,0,-256
7146,1,1,1401,1206,-195
7147,1,1,1182,1512,330
7148,0,0,74,0,-74
7149,1,0,60,0,-60
7150,1,0,38,0,-38
7151,0,0,34,0,-34
7152,1,0,41,0,-41
7153,0,0,33,0,-33
7154,0,0,0,0,0
7155,1,1,1168,1284,116
7156,1,1,349,1291,942
7157,1,1,997,1466,469
7158,1,0,40,0,-40
7159,1,0,89,0,-89
7160,0,0,10,0,-10
7161,1,0,20,0,-20
7162,1,0,54,0,-54
7163,1,0,84,0,-84
7164,0,0,13,0,-13
7165,0,0,58,0,-58
7166,1,0,84,0,-84
7167,1,0,9,0,-9
7168,1,0,23,0,-23
7169,1,1,336,1704,1368
7170,0,0,21,0,-21
7171,1,1,158,2218,2060
7172,1,0,23,0,-23
7173,0,0,65,0,-65
7174,1,1,280,1325,1045
7175,0,0,43,0,-43
7176,1,0,27,0,-27
7177,0,0,101,0,-101
7178,0,0,11,0,-11
7179,0,0,22,0,-22
7180,0,0,38,0,-38
7181,1,0,12,0,-12
7182,1,1,1285,1275,-10
7183,1,0,13,0,-13
7184,1,0,44,0,-44
7185,1,0,55,0,-55
7186,1,0,32,0,-32
7187,0,0,37,0,-37
7188,0,0,87,0,-87
7189,0,0,21,0,-21
7190,1,1,1565,1201,-364
7191,1,0,21,0,-21
7192,1,0,24,0,-24
7193,0,0,124,0,-124
7194,1,1,868,2431,1563
7195,1,1,1311,1225,-86
7196,1,1,819,1953,1134
7197,0,0,49,0,-49
7198,1,1,376,1606,1230
7199,1,1,437,1406,969
7200,1,0,63,0,-63
7201,0,0,55,0,-55
7202,1,0,8,0,-8
7203,1,0,87,0,-87
7204,1,0,64,0,-64
7205,1,1,527,1647,1120
7206,0,0,27,0,-27
7207,1,0,42,0,-42
7208,1,1,1883,1466,-417
7209,0,0,4,0,-4
7210,0,0,2,0,-2
7211,1,1,432,1285,853
7212,0,0,100,0,-100
7213,0,0,16,0,-16
7214,0,0,51,0,-51
7215,0,0,103,0,-103
7216,1,1,283,1269,986
7217,1,0,8,0,-8
7218,0,0,9,0,-9
7219,1,1,106,1699,1593
7220,0,0,63,0,-63
7221,0,0,36,0,-36
7222,1,0,20,0,-20
7223,1,1,423,1234,811
7224,1,0,2,0,-2
7225,0,0,9,0,-9
7226,1,0,15,0,-15
7227,0,0,10,0,-10
7228,1,1,296,1245,949
7229,1,0,8,0,-8
7230,0,0,38,0,-38
7231,0,0,81,0,-81
7232,1,1,124,1452,1328
7233,0,0,33,0,-33
7234,1,0,48,0,-48
7235,0,0,24,0,-24
7236,1,1,37,1529,1492
7237,1,0,84,0,-84
7238,0,0,28,0,-28
7239,1,1,118,1408,1290
7240,1,1,569,2704,2135
7241,0,0,0,0,0
7242,0,0,17,0,-17
7243,0,0,13,0,-13
7244,0,0,71,0,-71
7245,0,0,48,0,-48
7246,1,0,12,0,-12
7247,1,0,3,0,-3
7248,0,0,23,0,-23
7249,1,0,91,0,-91
7250,1,1,196,1218,1022
7251,0,0,46,0,-46
7252,0,0,11,0,-11
7253,1,0,22,0,-22
7254,0,0,4,0,-4
7255,1,0,63,0,-63
7256,0,0,28,0,-28
7257,1,0,78,0,-78
7258,1,0,89,0,-89
7259,1,0,5,0,-5
7260,0,0,13,0,-13
7261,0,0,23,0,-23
7262,1,0,32,0,-32
7263,1,1,113,1232,1119
7264,0,0,122,0,-122
7265,0,0,25,0,-25
7266,1,1,1045,1334,289
7267,0,0,40,0,-40
7268,1,1,256,1258,1002
7269,1,0,25,0,-25
7270,0,0,10,0,-10
7271,0,0,3,0,-3
7272,1,0,67,0,-67
7273,1,0,1,0,-1
7274,1,0,12,0,-12
7275,1,0,90,0,-90
7276,1,1,196,1458,1262
7277,0,0,9,0,-9
7278,0,0,72,0,-72
7279,1,1,335,1790,1455
7280,1,1,147,1719,1572
7281,0,0,24,0,-24
7282,1,0,57,0,-57
7283,1,0,29,0,-29
7284,1,1,570,1308,738
7285,1,1,221,1249,1028
7286,0,0,10,0,-10
7287,0,0,121,0,-121
7288,0,0,38,0,-38
7289,0,0,18,0,-18
7290,0,0,90,0,-90
7291,1,0,52,0,-52
7292,1,0,6,0,-6
7293,0,0,11,0,-11
7294,1,1,113,1201,1088
7295,0,0,10,0,-10
7296,1,0,58,0,-58
7297,0,0,66,0,-66
7298,0,0,0,0,0
7299,1,1,637,1476,839
7300,1,1,186,1304,1118
7301,0,0,42,0,-42
7302,0,0,78,0,-78
7303,1,0,10,0,-10
7304,1,0,1,0,-1
7305,1,1,231,1327,1096
7306,1,0,44,0,-44
7307,1,1,966,2032,1066
7308,1,1,56,1380,1324
7309,0,0,6,0,-6
7310,1,0,5,0,-5
7311,1,1,467,1433,966
7312,0,0,21,0,-21
7313,0,0,145,0,-145
7314,1,0,8,0,-8
7315,0,0,54,0,-54
7316,1,1,224,1286,1062
7317,1,1,233,1473,1240
7318,1,0,56,0,-56
7319,1,1,93,1532,1439
7320,0,0,25,0,-25
7321,1,0,4,0,-4
7322,1,0,18,0,-18
7323,1,1,1211,1459,248
7324,1,1,288,1493,1205
7325,1,1,292,1521,1229
7326,1,0,221,0,-221
7327,1,1,259,1400,1141
7328,1,0,35,0,-35
7329,0,0,13,0,-13
7330,1,0,12,0,-12
7331,1,0,14,0,-14
7332,1,1,877,1302,425
7333,1,1,91,1304,1213
7334,1,0,94,0,-94
7335,0,0,79,0,-79
7336,1,0,100,0,-100
7337,0,0,22,0,-22
7338,1,0,0,0,0
7339,1,0,131,0,-131
7340,1,0,116,0,-116
7341,0,0,126,0,-126
7342,0,0,85,0,-85
7343,1,1,431,1825,1394
7344,0,0,93,0,-93
7345,1,0,142,0,-142
7346,0,0,0,0,0
7347,1,0,2,0,-2
7348,0,0,37,0,-37
7349,0,0,31,0,-31
7350,1,1,90,1625,1535
7351,1,1,490,1344,854
7352,0,0,31,0,-31
7353,1,1,219,1587,1368
7354,1,0,45,0,-45
7355,1,1,126,1446,1320
7356,0,0,91,0,-91
7357,1,1,773,1203,430
7358,1,0,45,0,-45
7359,1,0,28,0,-28
7360,0,0,108,0,-108
7361,0,0,49,0,-49
7362,1,1,122,1433,1311
7363,1,0,113,0,-113
7364,0,0,16,0,-16
7365,1,1,822,1241,419
7366,0,0,11,0,-11
7367,0,0,68,0,-68
7368,1,0,31,0,-31
7369,1,0,39,0,-39
7370,1,1,824,1250,426
7371,0,0,22,0,-22
7372,1,1,187,1505,1318
7373,0,0,24,0,-24
7374,0,0,113,0,-113
7375,1,1,552,1576,1024
7376,1,0,29,0,-29
7377,0,0,3,0,-3
7378,1,0,86,0,-86
7379,0,0,1,0,-1
7380,0,0,60,0,-60
7381,0,0,29,0,-29
7382,0,0,2,0,-2
7383,0,0,6,0,-6
7384,1,1,221,1405,1184
7385,1,0,49,0,-49
7386,0,0,1,0,-1
7387,1,1,718,1499,781
7388,1,1,2109,1255,-854
7389,0,0,49,0,-49
7390,1,1,404,1281,877
7391,0,0,42,0,-42
7392,1,0,110,0,-110
7393,0,0,45,0,-45
7394,0,0,53,0,-53
7395,1,0,76,0,-76
7396,0,0,22,0,-22
7397,1,0,13,0,-13
7398,1,0,87,0,-87
7399,0,0,1,0,-1
7400,1,1,928,1556,628
7401,1,1,604,1644,1040
7402,1,0,1,0,-1
7403,0,0,47,0,-47
7404,1,0,113,0,-113
7405,1,1,1205,1385,180
7406,1,1,444,1569,1125
7407,0,0,2,0,-2
7408,1,1,568,1385,817
7409,0,0,84,0,-84
7410,1,0,160,0,-160
7411,0,0,58,0,-58
7412,1,0,26,0,-26
7413,1,0,61,0,-61
7414,0,0,16,0,-16
7415,1,1,291,2330,2039
7416,0,0,114,0,-114
7417,1,0,22,0,-22
7418,0,0,48,0,-48
7419,1,0,2,0,-2
7420,0,0,81,0,-81
7421,0,0,57,0,-57
7422,1,0,314,0,-314
7423,1,0,13,0,-13
7424,0,0,57,0,-57
7425,0,0,11,0,-11
7426,0,0,10,0,-10
7427,1,1,446,1296,850
7428,1,0,59,0,-59
7429,1,1,381,2487,2106
7430,1,1,1311,1291,-20
7431,1,1,291,1563,1272
7432,0,0,31,0,-31
7433,1,1,165,1205,1040
7434,1,1,497,1447,950
7435,1,0,28,0,-28
7436,0,0,43,0,-43
7437,1,1,631,3615,2984
7438,1,0,11,0,-11
7439,0,0,44,0,-44
7440,1,1,77,1305,1228
7441,0,0,15,0,-15
7442,0,0,2,0,-2
7443,1,1,389,1925,1536
7444,1,0,39,0,-39
7445,0,0,6,0,-6
7446,1,0,98,0,-98
7447,1,0,13,0,-13
7448,0,0,192,0,-192
7449,0,0,22,0,-22
7450,1,0,10,0,-10
7451,0,0,77,0,-77
7452,0,0,5,0,-5
7453,1,0,30,0,-30
7454,1,0,8,0,-8
7455,0,0,15,0,-15
7456,1,1,699,2102,1403
7457,1,1,117,1520,1403
7458,1,0,1,0,-1
7459,0,0,166,0,-166
7460,1,0,17,0,-17
7461,0,0,33,0,-33
7462,1,1,96,2074,1978
7463,1,1,419,1626,1207
7464,0,0,72,0,-72
7465,0,0,162,0,-162
7466,1,1,314,1330,1016
7467,0,0,66,0,-66
7468,1,0,265,0,-265
7469,1,1,151,1450,1299
7470,0,0,95,0,-95
7471,1,0,42,0,-42
7472,1,1,557,1237,680
7473,1,0,0,0,0
7474,1,0,10,0,-10
7475,1,0,146,0,-146
7476,0,0,19,0,-19
7477,1,0,7,0,-7
7478,1,1,2045,1812,-233
7479,1,0,118,0,-118
7480,0,0,18,0,-18
7481,1,1,87,1475,1388
7482,1,1,1099,1958,859
7483,1,0,45,0,-45
7484,1,0,21,0,-21
7485,0,0,5,0,-5
7486,0,0,77,0,-77
7487,1,0,13,0,-13
7488,1,0,3,0,-3
7489,1,1,108,1411,1303
7490,1,1,736,1234,498
7491,1,0,6,0,-6
7492,0,0,5,0,-5
7493,1,0,65,0,-65
7494,1,1,409,1670,1261
7495,0,0,48,0,-48
7496,0,0,24,0,-24
7497,1,1,41,2369,2328
7498,1,0,11,0,-11
7499,0,0,136,0,-136
7500,0,0,54,0,-54
7501,0,0,38,0,-38
7502,1,0,1,0,-1
7503,0,0,24,0,-24
7504,1,1,242,1386,1144
7505,0,0,94,0,-94
7506,0,0,22,0,-22
7507,1,1,425,1240,815
7508,0,0,0,0,0
7509,0,0,68,0,-68
7510,0,0,7,0,-7
7511,0,0,28,0,-28
7512,0,0,210,0,-210
7513,0,0,19,0,-19
7514,1,1,748,1216,468
7515,0,0,81,0,-81
7516,0,0,30,0,-30
7517,1,0,89,0,-89
7518,1,1,295,1724,1429
7519,1,0,63,0,-63
7520,1,1,171,1534,1363
7521,1,0,0,0,0
7522,1,0,19,0,-19
7523,0,0,38,0,-38
7524,0,0,13,0,-13
7525,1,1,165,2080,1915
7526,0,0,0,0,0
7527,0,0,36,0,-36
7528,1,0,262,0,-262
7529,0,0,74,0,-74
7530,0,0,21,0,-21
7531,1,1,360,1310,950
7532,0,0,52,0,-52
7533,1,0,294,0,-294
7534,1,1,87,1637,1550
7535,1,1,563,1858,1295
7536,1,1,90,1867,1777
7537,1,0,1,0,-1
7538,1,1,233,2828,2595
7539,1,0,58,0,-58
7540,1,0,0,0,0
7541,1,1,286,1452,1166
7542,1,1,41,1930,1889
7543,1,1,360,1586,1226
7544,0,0,78,0,-78
7545,1,0,83,0,-83
7546,1,0,110,0,-110
7547,1,1,538,1344,806
7548,1,0,114,0,-114
7549,1,0,28,0,-28
7550,0,0,83,0,-83
7551,0,0,16,0,-16
7552,1,1,31,1327,1296
7553,0,0,15,0,-15
7554,1,1,179,1487,1308
7555,1,0,15,0,-15
7556,1,0,6,0,-6
7557,1,0,9,0,-9
7558,0,0,29,0,-29
7559,1,1,269,1429,1160
7560,1,1,602,1340,738
7561,0,0,38,0,-38
7562,1,1,153,1557,1404
7563,0,0,135,0,-135
7564,1,1,758,1202,444
7565,1,0,0,0,0
7566,1,1,613,1428,815
7567,1,1,150,1531,1381
7568,1,0,5,0,-5
7569,0,0,29,0,-29
7570,0,0,4,0,-4
7571,0,0,4,0,-4
7572,1,0,21,0,-21
7573,1,1,680,1659,979
7574,1,0,0,0,0
7575,0,0,15,0,-15
7576,1,1,78,1397,1319
7577,0,0,109,0,-109
7578,1,1,412,1288,876
7579,0,0,34,0,-34
7580,1,0,57,0,-57
7581,1,0,43,0,-43
7582,1,1,104,1267,1163
7583,0,0,20,0,-20
7584,1,0,70,0,-70
7585,1,1,153,1515,1362
7586,1,1,1025,1236,211
7587,0,0,116,0,-116
7588,1,1,402,1494,1092
7589,1,0,24,0,-24
7590,1,0,40,0,-40
7591,1,0,7,0,-7
7592,0,0,7,0,-7
7593,1,1,496,1217,721
7594,0,0,58,0,-58
7595,1,0,111,0,-111
7596,1,0,10,0,-10
7597,1,0,7,0,-7
7598,1,0,84,0,-84
7599,0,0,126,0,-126
7600,1,0,75,0,-75
7601,1,1,1476,1291,-185
7602,1,0,19,0,-19
7603,1,1,69,2113,2044
7604,0,0,68,0,-68
7605,0,0,59,0,-59
7606,1,0,119,0,-119
7607,0,0,33,0,-33
7608,1,0,55,0,-55
7609,0,0,105,0,-105
7610,0,0,25,0,-25
7611,1,0,12,0,-12
7612,1,0,57,0,-57
7613,1,0,194,0,-194
7614,1,0,6,0,-6
7615,1,0,33,0,-33
7616,0,0,51,0,-51
7617,1,1,486,1289,803
7618,1,0,171,0,-171
7619,1,0,64,0,-64
7620,1,1,252,1649,1397
7621,0,0,9,0,-9
7622,1,0,45,0,-45
7623,0,0,31,0,-31
7624,1,0,20,0,-20
7625,1,1,56,1310,1254
7626,0,0,29,0,-29
7627,1,0,130,0,-130
7628,0,0,50,0,-50
7629,1,0,99,0,-99
7630,1,0,8,0,-8
7631,1,1,255,1252,997
7632,0,0,33,0,-33
7633,1,1,2760,1231,-1529
7634,1,0,14,0,-14
7635,1,1,357,1386,1029
7636,1,0,25,0,-25
7637,1,0,78,0,-78
7638,0,0,9,0,-9
7639,1,1,1475,2855,1380
7640,1,0,208,0,-208
7641,0,0,2,0,-2
7642,1,0,29,0,-29
7643,0,0,17,0,-17
7644,0,0,21,0,-21
7645,1,0,31,0,-31
7646,0,0,125,0,-125
7647,1,1,391,1506,1115
7648,1,1,314,1226,912
7649,1,0,52,0,-52
7650,1,0,3,0,-3
7651,0,0,7,0,-7
7652,1,1,1262,1354,92
7653,1,0,20,0,-20
7654,1,1,685,1503,818
7655,1,0,85,0,-85
7656,1,0,13,0,-13
7657,0,0,78,0,-78
7658,0,0,125,0,-125
7659,0,0,13,0,-13
7660,1,1,102,1206,1104
7661,0,0,101,0,-101
7662,0,0,96,0,-96
7663,0,0,17,0,-17
7664,1,0,134,0,-134
7665,0,0,12,0,-12
7666,1,0,72,0,-72
7667,1,1,331,1261,930
7668,1,0,16,0,-16
7669,0,0,7,0,-7
7670,0,0,50,0,-50
7671,0,0,54,0,-54
7672,1,0,9,0,-9
7673,0,0,128,0,-128
7674,1,1,314,1406,1092
7675,1,1,1202,1296,94
7676,1,0,2,0,-2
7677,0,0,44,0,-44
7678,0,0,63,0,-63
7679,0,0,57,0,-57
7680,1,0,66,0,-66
7681,1,1,220,1408,1188
7682,0,0,69,0,-69
7683,0,0,6,0,-6
7684,0,0,120,0,-120
7685,0,0,109,0,-109
7686,0,0,0,0,0
7687,1,0,5,0,-5
7688,1,0,13,0,-13
7689,1,0,130,0,-130
7690,1,0,34,0,-34
7691,0,0,27,0,-27
7692,0,0,9,0,-9
7693,0,0,29,0,-29
7694,1,1,424,1214,790
7695,1,0,45,0,-45
7696,1,1,406,1300,894
7697,1,0,17,0,-17
7698,0,0,6,0,-6
7699,0,0,57,0,-57
7700,0,0,5,0,-5
7701,0,0,37,0,-37
7702,1,1,459,1309,850
7703,0,0,32,0,-32
7704,1,0,28,0,-28
7705,0,0,120,0,-120
7706,0,0,83,0,-83
7707,0,0,8,0,-8
7708,0,0,77,0,-77
7709,1,1,674,1217,543
7710,0,0,104,0,-104
7711,1,0,74,0,-74
7712,1,1,405,1286,881
7713,0,0,10,0,-10
7714,1,1,487,1965,1478
7715,1,0,5,0,-5
7716,1,1,206,1672,1466
7717,1,1,128,1246,1118
7718,1,1,167,1567,1400
7719,0,0,16,0,-16
7720,0,0,49,0,-49
7721,0,0,45,0,-45
7722,1,0,31,0,-31
7723,0,0,8,0,-8
7724,0,0,3,0,-3
7725,1,0,13,0,-13
7726,0,0,11,0,-11
7727,1,0,22,0,-22
7728,1,0,33,0,-33
7729,1,1,585,1400,815
7730,1,0,72,0,-72
7731,1,1,589,2568,1979
7732,1,0,105,0,-105
7733,0,0,34,0,-34
7734,0,0,44,0,-44
7735,1,1,676,1291,615
7736,0,0,18,0,-18
7737,1,1,211,1263,1052
7738,1,0,15,0,-15
7739,1,0,16,0,-16
7740,0,0,13,0,-13
7741,1,0,138,0,-138
7742,0,0,12,0,-12
7743,0,0,46,0,-46
7744,0,0,2,0,-2
7745,1,0,12,0,-12
7746,1,0,20,0,-20
7747,1,1,596,1670,1074
7748,0,0,28,0,-28
7749,0,0,60,0,-60
7750,1,1,154,2232,2078
7751,0,0,119,0,-119
7752,1,1,1231,1625,394
7753,1,1,1968,1283,-685
7754,1,0,74,0,-74
7755,0,0,128,0,-128
7756,0,0,37,0,-37
7757,1,1,1112,1244,132
7758,1,1,849,1538,689
7759,0,0,28,0,-28
7760,1,0,17,0,-17
7761,0,0,39,0,-39
7762,0,0,24,0,-24
7763,1,0,40,0,-40
7764,1,0,161,0,-161
7765,1,1,464,1234,770
7766,1,0,104,0,-104
7767,0,0,7,0,-7
7768,0,0,103,0,-103
7769,0,0,3,0,-3
7770,1,0,48,0,-48
7771,0,0,14,0,-14
7772,1,0,73,0,-73
7773,0,0,126,0,-126
7774,1,0,24,0,-24
7775,1,1,87,1365,1278
7776,0,0,21,0,-21
7777,1,1,303,2062,1759
7778,1,0,47,0,-47
7779,1,0,4,0,-4
7780,0,0,30,0,-30
7781,0,0,6,0,-6
7782,0,0,92,0,-92
7783,0,0,91,0,-91
7784,0,0,1,0,-1
7785,0,0,50,0,-50
7786,1,0,9,0,-9
7787,1,1,1223,1502,279
7788,0,0,1,0,-1
7789,1,1,262,1449,1187
7790,1,0,0,0,0
7791,1,0,178,0,-178
7792,0,0,420,0,-420
7793,0,0,6,0,-6
7794,0,0,45,0,-45
7795,0,0,75,0,-75
7796,1,0,108,0,-108
7797,1,0,76,0,-76
7798,0,0,42,0,-42
7799,1,1,207,1574,1367
7800,0,0,9,0,-9
7801,1,0,11,0,-11
7802,1,1,110,1633,1523
7803,1,1,972,1663,691
7804,1,0,12,0,-12
7805,1,1,1593,1573,-20
7806,0,0,2,0,-2
7807,1,0,13,0,-13
7808,0,0,11,0,-11
7809,1,1,845,2851,2006
7810,1,1,492,1337,845
7811,1,1,447,1401,954
7812,1,1,990,3111,2121
7813,1,1,190,3103,2913
7814,1,1,256,1202,946
7815,0,0,51,0,-51
7816,0,0,25,0,-25
7817,0,0,35,0,-35
7818,0,0,17,0,-17
7819,1,1,79,2455,2376
7820,1,0,151,0,-151
7821,1,0,33,0,-33
7822,0,0,87,0,-87
7823,1,0,10,0,-10
7824,1,0,7,0,-7
7825,1,1,310,1465,1155
7826,0,0,110,0,-110
7827,1,0,60,0,-60
7828,0,0,156,0,-156
7829,1,0,124,0,-124
7830,0,0,51,0,-51
7831,1,1,776,1203,427
7832,0,0,25,0,-25
7833,0,0,37,0,-37
7834,1,0,140,0,-140
7835,1,1,110,1638,1528
7836,1,0,0,0,0
7837,1,0,77,0,-77
7838,1,0,1,0,-1
7839,0,0,42,0,-42
7840,0,0,68,0,-68
7841,0,0,15,0,-15
7842,1,0,11,0,-11
7843,1,1,57,2084,2027
7844,0,0,37,0,-37
7845,1,1,444,1542,1098
7846,1,1,1623,1400,-223
7847,1,0,254,0,-254
7848,0,0,46,0,-46
7849,1,0,0,0,0
7850,0,0,47,0,-47
7851,1,0,0,0,0
7852,1,0,34,0,-34
7853,1,0,20,0,-20
7854,0,0,12,0,-12
7855,1,1,1263,1423,160
7856,0,0,36,0,-36
7857,0,0,0,0,0
7858,1,0,106,0,-106
7859,0,0,481,0,-481
7860,1,0,61,0,-61
7861,1,1,355,1501,1146
7862,0,0,53,0,-53
7863,0,0,136,0,-136
7864,1,0,112,0,-112
7865,0,0,3,0,-3
7866,0,0,29,0,-29
7867,1,1,239,1518,1279
7868,1,1,219,1247,1028
7869,0,0,223,0,-223
7870,1,1,316,1263,947
7871,0,0,16,0,-16
7872,0,0,148,0,-148
7873,1,1,866,2606,1740
7874,1,0,62,0,-62
7875,0,0,51,0,-51
7876,1,1,945,1598,653
7877,1,0,73,0,-73
7878,1,0,33,0,-33
7879,1,1,550,3697,3147
7880,1,0,27,0,-27
7881,1,1,319,1285,966
7882,0,0,53,0,-53
7883,0,0,183,0,-183
7884,1,0,116,0,-116
7885,1,1,1540,1409,-131
7886,0,0,11,0,-11
7887,0,0,122,0,-122
7888,0,0,246,0,-246
7889,0,0,35,0,-35
7890,0,0,3,0,-3
7891,1,0,22,0,-22
7892,1,1,694,1231,537
7893,1,1,1078,1683,605
7894,1,1,259,2454,2195
7895,0,0,43,0,-43
7896,1,1,706,1405,699
7897,1,1,1275,1256,-19
7898,1,1,801,1256,455
7899,0,0,117,0,-117
7900,1,0,12,0,-12
7901,1,0,119,0,-119
7902,0,0,58,0,-58
7903,0,0,171,0,-171
7904,0,0,79,0,-79
7905,1,0,24,0,-24
7906,1,1,173,1267,1094
7907,0,0,44,0,-44
7908,1,0,52,0,-52
7909,1,0,3,0,-3
7910,1,0,2,0,-2
7911,0,0,37,0,-37
7912,0,0,52,0,-52
7913,0,0,80,0,-80
7914,1,0,4,0,-4
7915,1,0,8,0,-8
7916,1,1,305,2684,2379
7917,1,0,5,0,-5
7918,1,1,80,1369,1289
7919,1,1,1379,2433,1054
7920,1,0,111,0,-111
7921,1,1,896,2757,1861
7922,0,0,8,0,-8
7923,0,0,5,0,-5
7924,1,0,81,0,-81
7925,0,0,12,0,-12
7926,1,1,614,2082,1468
7927,1,1,506,1430,924
7928,0,0,40,0,-40
7929,1,0,90,0,-90
7930,0,0,2,0,-2
7931,0,0,172,0,-172
7932,1,0,107,0,-107
7933,1,1,1131,1463,332
7934,0,0,6,0,-6
7935,0,0,35,0,-35
7936,0,0,178,0,-178
7937,0,0,6,0,-6
7938,0,0,5,0,-5
7939,0,0,15,0,-15
7940,0,0,50,0,-50
7941,1,0,60,0,-60
7942,1,1,1418,1557,139
7943,1,0,51,0,-51
7944,1,1,358,1426,1068
7945,1,1,240,1657,1417
7946,1,0,87,0,-87
7947,1,0,2,0,-2
7948,1,0,133,0,-133
7949,1,0,7,0,-7
7950,0,0,52,0,-52
7951,1,1,665,1200,535
7952,1,0,16,0,-16
7953,1,1,450,1496,1046
7954,0,0,14,0,-14
7955,1,1,89,1452,1363
7956,1,0,45,0,-45
7957,1,1,219,1455,1236
7958,0,0,173,0,-173
7959,1,1,1088,1332,244
7960,0,0,21,0,-21
7961,1,0,18,0,-18
7962,0,0,30,0,-30
7963,1,0,94,0,-94
7964,1,1,54,1230,1176
7965,1,1,439,1226,787
7966,0,0,21,0,-21
7967,1,0,6,0,-6
7968,0,0,3,0,-3
7969,1,0,12,0,-12
7970,0,0,10,0,-10
7971,1,0,0,0,0
7972,1,1,1440,2256,816
7973,0,0,1,0,-1
7974,1,0,64,0,-64
7975,1,0,10,0,-10
7976,0,0,60,0,-60
7977,1,0,23,0,-23
7978,0,0,81,0,-81
7979,1,1,316,1268,952
7980,1,0,0,0,0
7981,1,1,1050,2008,958
7982,1,0,112,0,-112
7983,1,0,81,0,-81
7984,1,1,19,1349,1330
7985,0,0,17,0,-17
7986,1,0,55,0,-55
7987,1,1,1092,1263,171
7988,1,1,103,1688,1585
7989,0,0,8,0,-8
7990,0,0,93,0,-93
7991,0,0,16,0,-16
7992,0,0,38,0,-38
7993,1,0,19,0,-19
7994,1,0,3,0,-3
7995,0,0,70,0,-70
7996,0,0,47,0,-47
7997,0,0,105,0,-105
7998,1,0,29,0,-29
7999,0,0,27,0,-27
8000,0,0,58,0,-58
8001,1,1,100,1384,1284
8002,0,0,2,0,-2
8003,1,0,184,0,-184
8004,1,0,35,0,-35
8005,0,0,24,0,-24
8006,1,0,12,0,-12
8007,1,1,1609,1772,163
8008,1,0,6,0,-6
8009,1,0,4,0,-4
8010,1,1,1052,1253,201
8011,1,1,667,1511,844
8012,0,0,38,0,-38
8013,1,1,148,1297,1149
8014,0,0,48,0,-48
8015,1,1,434,1201,767
8016,0,0,75,0,-75
8017,1,0,25,0,-25
8018,0,0,66,0,-66
8019,1,0,90,0,-90
8020,1,1,1608,1559,-49
8021,0,0,11,0,-11
8022,1,1,79,1919,1840
8023,1,1,239,2245,2006
8024,1,0,30,0,-30
8025,1,0,19,0,-19
8026,1,0,66,0,-66
8027,1,0,66,0,-66
8028,1,1,707,1298,591
8029,1,0,13,0,-13
8030,0,0,0,0,0
8031,0,0,7,0,-7
8032,0,0,51,0,-51
8033,1,0,93,0,-93
8034,1,1,112,1404,1292
8035,1,1,96,1798,1702
8036,0,0,7,0,-7
8037,0,0,86,0,-86
8038,0,0,7,0,-7
8039,0,0,4,0,-4
8040,1,1,143,2034,1891
8041,1,1,25,1560,1535
8042,1,1,487,2162,1675
8043,0,0,19,0,-19
8044,0,0,100,0,-100
8045,0,0,40,0,-40
8046,0,0,152,0,-152
8047,0,0,48,0,-48
8048,1,1,301,1985,1684
8049,0,0,13,0,-13
8050,0,0,12,0,-12
8051,1,0,12,0,-12
8052,1,1,324,3081,2757
8053,0,0,141,0,-141
8054,1,0,8,0,-8
8055,1,1,485,1340,855
8056,0,0,11,0,-11
8057,1,0,54,0,-54
8058,0,0,21,0,-21
8059,0,0,66,0,-66
8060,1,1,739,2919,2180
8061,1,0,15,0,-15
8062,0,0,32,0,-32
8063,0,0,13,0,-13
8064,1,1,1498,1303,-195
8065,1,0,112,0,-112
8066,1,0,104,0,-104
8067,1,1,506,1314,808
8068,1,0,55,0,-55
8069,0,0,9,0,-9
8070,1,1,332,1473,1141
8071,0,0,78,0,-78
8072,1,0,44,0,-44
8073,0,0,78,0,-78
8074,0,0,11,0,-11
8075,1,0,63,0,-63
8076,1,0,24,0,-24
8077,0,0,14,0,-14
8078,1,0,38,0,-38
8079,1,1,89,2147,2058
8080,1,1,340,1310,970
8081,0,0,52,0,-52
8082,1,0,9,0,-9
8083,0,0,4,0,-4
8084,1,1,619,1477,858
8085,0,0,30,0,-30
8086,0,0,45,0,-45
8087,1,1,112,1309,1197
8088,1,0,1,0,-1
8089,1,1,354,1726,1372
8090,0,0,159,0,-159
8091,1,0,14,0,-14
8092,0,0,42,0,-42
8093,0,0,43,0,-43
8094,1,1,2901,1840,-1061
8095,1,0,136,0,-136
8096,0,0,4,0,-4
8097,1,0,132,0,-132
8098,0,0,26,0,-26
8099,1,1,254,1739,1485
8100,0,0,146,0,-146
8101,1,0,83,0,-83
8102,0,0,90,0,-90
8103,0,0,28,0,-28
8104,1,0,4,0,-4
8105,1,1,264,1330,1066
8106,1,0,49,0,-49
8107,1,0,56,0,-56
8108,0,0,68,0,-68
8109,0,0,2,0,-2
8110,0,0,5,0,-5
8111,1,1,49,1527,1478
8112,1,0,24,0,-24
8113,1,0,13,0,-13
8114,0,0,13,0,-13
8115,0,0,32,0,-32
8116,1,0,50,0,-50
8117,1,0,25,0,-25
8118,0,0,4,0,-4
8119,1,1,167,1524,1357
8120,1,0,105,0,-105
8121,1,1,57,3657,3600
8122,0,0,20,0,-20
8123,0,0,68,0,-68
8124,1,0,72,0,-72
8125,1,1,763,1354,591
8126,1,0,29,0,-29
8127,1,0,19,0,-19
8128,1,0,29,0,-29
8129,1,1,586,1413,827
8130,0,0,11,0,-11
8131,0,0,34,0,-34
8132,1,1,601,1354,753
8133,1,1,151,1623,1472
8134,1,0,82,0,-82
8135,1,1,266,1412,1146
8136,1,0,109,0,-109
8137,1,1,209,1260,1051
8138,0,0,0,0,0
8139,0,0,48,0,-48
8140,1,1,912,1239,327
8141,1,0,111,0,-111
8142,0,0,56,0,-56
8143,1,0,14,0,-14
8144,0,0,68,0,-68
8145,1,1,276,1679,1403
8146,1,0,80,0,-80
8147,1,0,80,0,-80
8148,0,0,108,0,-108
8149,1,1,544,1615,1071
8150,0,0,81,0,-81
8151,0,0,65,0,-65
8152,1,1,298,1635,1337
8153,1,0,12,0,-12
8154,1,0,29,0,-29
8155,0,0,12,0,-12
8156,1,1,274,1285,1011
8157,1,0,49,0,-49
8158,1,0,50,0,-50
8159,0,0,5,0,-5
8160,0,0,32,0,-32
8161,0,0,15,0,-15
8162,1,1,526,1239,713
8163,1,0,0,0,0
8164,1,1,148,2385,2237
8165,1,0,55,0,-55
8166,0,0,3,0,-3
8167,0,0,29,0,-29
8168,1,1,702,1428,726
8169,1,0,47,0,-47
8170,1,1,517,1270,753
8171,1,0,28,0,-28
8172,1,1,393,2002,1609
8173,1,0,127,0,-127
8174,1,1,366,1279,913
8175,0,0,0,0,0
8176,1,0,28,0,-28
8177,1,1,148,1343,1195
8178,0,0,19,0,-19
8179,0,0,56,0,-56
8180,0,0,2,0,-2
8181,0,0,71,0,-71
8182,1,0,5,0,-5
8183,1,0,33,0,-33
8184,0,0,20,0,-20
8185,0,0,12,0,-12
8186,1,1,313,1396,1083
8187,1,0,9,0,-9
8188,1,1,751,1326,575
8189,1,1,57,1628,1571
8190,1,1,877,1436,559
8191,1,0,108,0,-108
8192,1,1,862,2012,1150
8193,1,0,77,0,-77
8194,0,0,24,0,-24
8195,1,1,13,1282,1269
8196,1,0,19,0,-19
8197,1,1,308,1598,1290
8198,0,0,20,0,-20
8199,0,0,22,0,-22
8200,1,0,25,0,-25
8201,1,0,6,0,-6
8202,0,0,31,0,-31
8203,1,0,5,0,-5
8204,0,0,31,0,-31
8205,0,0,1,0,-1
8206,0,0,3,0,-3
8207,1,1,1003,2361,1358
8208,1,1,95,1926,1831
8209,1,0,57,0,-57
8210,0,0,53,0,-53
8211,0,0,27,0,-27
8212,0,0,45,0,-45
8213,1,0,17,0,-17
8214,1,1,195,1988,1793
8215,1,0,80,0,-80
8216,1,0,57,0,-57
8217,1,0,53,0,-53
8218,1,1,19,4030,4011
8219,1,0,32,0,-32
8220,1,1,1896,2024,128
8221,0,0,70,0,-70
8222,0,0,6,0,-6
8223,0,0,20,0,-20
8224,0,0,27,0,-27
8225,0,0,19,0,-19
8226,1,1,198,1437,1239
8227,1,0,10,0,-10
8228,1,1,143,1485,1342
8229,1,0,57,0,-57
8230,0,0,8,0,-8
8231,0,0,5,0,-5
8232,1,1,703,1278,575
8233,1,1,351,1673,1322
8234,1,1,402,2228,1826
8235,1,1,113,1323,1210
8236,1,1,547,1209,662
8237,0,0,106,0,-106
8238,1,0,7,0,-7
8239,1,0,18,0,-18
8240,0,0,14,0,-14
8241,1,1,223,1310,1087
8242,0,0,93,0,-93
8243,1,1,754,1327,573
8244,1,1,48,1602,1554
8245,0,0,2,0,-2
8246,0,0,22,0,-22
8247,1,1,408,1605,1197
8248,1,1,142,1288,1146
8249,0,0,67,0,-67
8250,1,0,87,0,-87
8251,0,0,115,0,-115
8252,0,0,33,0,-33
8253,1,1,217,1383,1166
8254,1,1,791,1291,500
8255,1,0,8,0,-8
8256,0,0,80,0,-80
8257,0,0,8,0,-8
8258,1,0,56,0,-56
8259,0,0,15,0,-15
8260,0,0,190,0,-190
8261,0,0,73,0,-73
8262,0,0,41,0,-41
8263,0,0,40,0,-40
8264,0,0,155,0,-155
8265,1,0,79,0,-79
8266,1,0,54,0,-54
8267,1,0,25,0,-25
8268,1,1,42,1716,1674
8269,1,0,14,0,-14
8270,1,0,49,0,-49
8271,1,0,49,0,-49
8272,0,0,79,0,-79
8273,1,1,166,1660,1494
8274,1,1,354,1265,911
8275,0,0,75,0,-75
8276,0,0,22,0,-22
8277,1,0,15,0,-15
8278,1,1,302,1251,949
8279,1,0,94,0,-94
8280,0,0,0,0,0
8281,1,1,91,1447,1356
8282,0,0,64,0,-64
8283,0,0,8,0,-8
8284,0,0,41,0,-41
8285,1,0,62,0,-62
8286,1,1,418,2596,2178
8287,0,0,69,0,-69
8288,0,0,79,0,-79
8289,0,0,13,0,-13
8290,1,1,1597,1657,60
8291,0,0,10,0,-10
8292,0,0,46,0,-46
8293,1,1,513,1237,724
8294,1,0,13,0,-13
8295,1,0,64,0,-64
8296,1,1,132,1330,1198
8297,1,1,39,1257,1218
8298,1,0,21,0,-21
8299,1,0,141,0,-141
8300,1,0,62,0,-62
8301,0,0,12,0,-12
8302,1,1,634,2365,1731
8303,0,0,11,0,-11
8304,0,0,8,0,-8
8305,0,0,3,0,-3
8306,0,0,127,0,-127
8307,1,0,10,0,-10
8308,1,0,148,0,-148
8309,1,1,749,1286,537
8310,1,0,200,0,-200
8311,1,1,716,1347,631
8312,1,1,262,1313,1051
8313,0,0,62,0,-62
8314,0,0,20,0,-20
8315,1,1,244,1458,1214
8316,0,0,36,0,-36
8317,0,0,0,0,0
8318,0,0,36,0,-36
8319,1,1,875,1238,363
8320,1,1,142,1313,1171
8321,0,0,123,0,-123
8322,0,0,13,0,-13
8323,1,0,2,0,-2
8324,0,0,16,0,-16
8325,1,0,29,0,-29
8326,0,0,22,0,-22
8327,0,0,163,0,-163
8328,0,0,8,0,-8
8329,0,0,30,0,-30
8330,1,1,49,2136,2087
8331,1,1,275,1631,1356
8332,1,1,47,1375,1328
8333,1,1,739,1364,625
8334,0,0,215,0,-215
8335,0,0,142,0,-142
8336,0,0,15,0,-15
8337,1,1,153,1285,1132
8338,1,0,23,0,-23
8339,1,0,38,0,-38
8340,1,1,177,1599,1422
8341,1,0,5,0,-5
8342,1,1,648,1436,788
8343,0,0,21,0,-21
8344,0,0,24,0,-24
8345,1,0,47,0,-47
8346,1,1,59,1282,1223
8347,1,0,15,0,-15
8348,0,0,44,0,-44
8349,0,0,149,0,-149
8350,1,0,46,0,-46
8351,0,0,6,0,-6
8352,1,1,151,1530,1379
8353,0,0,148,0,-148
8354,1,0,31,0,-31
8355,1,1,2541,1272,-1269
8356,1,1,506,1679,1173
8357,0,0,13,0,-13
8358,0,0,87,0,-87
8359,1,1,2107,1236,-871
8360,0,0,63,0,-63
8361,1,0,11,0,-11
8362,0,0,131,0,-131
8363,0,0,24,0,-24
8364,0,0,9,0,-9
8365,1,0,18,0,-18
8366,0,0,44,0,-44
8367,1,1,704,1364,660
8368,1,1,279,2306,2027
8369,1,0,69,0,-69
8370,1,0,58,0,-58
8371,0,0,130,0,-130
8372,0,0,56,0,-56
8373,1,1,1683,1613,-70
8374,1,0,31,0,-31
8375,1,1,58,2029,1971
8376,0,0,20,0,-20
8377,0,0,19,0,-19
8378,0,0,76,0,-76
8379,0,0,136,0,-136
8380,1,1,752,1498,746
8381,1,0,26,0,-26
8382,1,0,2,0,-2
8383,1,0,26,0,-26
8384,0,0,50,0,-50
8385,1,1,362,1286,924
8386,1,1,135,1418,1283
8387,1,0,25,0,-25
8388,0,0,127,0,-127
8389,1,1,198,1236,1038
8390,1,0,45,0,-45
8391,1,0,2,0,-2
8392,1,1,16,1338,1322
8393,1,0,40,0,-40
8394,1,0,157,0,-157
8395,1,1,1084,1764,680
8396,1,1,229,1693,1464
8397,1,1,3100,1387,-1713
8398,1,0,10,0,-10
8399,1,0,60,0,-60
8400,0,0,66,0,-66
8401,0,0,36,0,-36
8402,0,0,70,0,-70
8403,1,1,411,1510,1099
8404,0,0,1,0,-1
8405,0,0,149,0,-149
8406,1,1,547,1662,1115
8407,1,0,46,0,-46
8408,1,0,32,0,-32
8409,0,0,184,0,-184
8410,0,0,14,0,-14
8411,0,0,75,0,-75
8412,1,0,0,0,0
8413,0,0,33,0,-33
8414,0,0,26,0,-26
8415,0,0,47,0,-47
8416,0,0,254,0,-254
8417,1,0,87,0,-87
8418,1,1,823,4758,3935
8419,0,0,9,0,-9
8420,1,0,80,0,-80
8421,1,1,77,2547,2470
8422,0,0,134,0,-134
8423,1,1,433,1202,769
8424,1,1,215,1313,1098
8425,0,0,17,0,-17
8426,1,0,8,0,-8
8427,0,0,1,0,-1
8428,0,0,4,0,-4
8429,1,0,98,0,-98
8430,1,1,249,1429,1180
8431,1,1,942,1981,1039
8432,0,0,31,0,-31
8433,0,0,245,0,-245
8434,1,1,106,1676,1570
8435,0,0,2,0,-2
8436,0,0,100,0,-100
8437,1,0,69,0,-69
8438,1,0,1,0,-1
8439,1,1,526,1564,1038
8440,0,0,267,0,-267
8441,1,0,16,0,-16
8442,0,0,57,0,-57
8443,1,1,317,1931,1614
8444,1,1,1557,1860,303
8445,1,1,29,2103,2074
8446,0,0,63,0,-63
8447,1,0,82,0,-82
8448,0,0,156,0,-156
8449,1,0,20,0,-20
8450,1,1,208,1230,1022
8451,0,0,55,0,-55
8452,1,1,124,1327,1203
8453,0,0,10,0,-10
8454,0,0,37,0,-37
8455,1,1,675,1633,958
8456,1,0,80,0,-80
8457,0,0,9,0,-9
8458,0,0,74,0,-74
8459,1,1,730,1284,554
8460,0,0,3,0,-3
8461,1,0,41,0,-41
8462,1,1,147,1570,1423
8463,1,1,657,1783,1126
8464,1,0,59,0,-59
8465,0,0,54,0,-54
8466,0,0,71,0,-71
8467,1,1,293,1328,1035
8468,1,0,3,0,-3
8469,1,1,350,1321,971
8470,0,0,4,0,-4
8471,0,0,58,0,-58
8472,1,1,990,2390,1400
8473,1,1,361,1390,1029
8474,0,0,315,0,-315
8475,0,0,20,0,-20
8476,1,1,816,1255,439
8477,1,0,17,0,-17
8478,1,0,16,0,-16
8479,1,0,77,0,-77
8480,0,0,44,0,-44
8481,1,1,1045,1213,168
8482,1,1,137,1431,1294
8483,0,0,36,0,-36
8484,1,0,20,0,-20
8485,1,0,9,0,-9
8486,1,1,790,1228,438
8487,1,0,37,0,-37
8488,1,1,76,1321,1245
8489,0,0,29,0,-29
8490,1,1,244,1460,1216
8491,1,0,22,0,-22
8492,0,0,23,0,-23
8493,0,0,23,0,-23
8494,1,0,21,0,-21
8495,0,0,4,0,-4
8496,1,0,39,0,-39
8497,1,1,1683,1674,-9
8498,1,1,416,1486,1070
8499,1,0,75,0,-75
8500,1,0,18,0,-18
8501,0,0,33,0,-33
8502,0,0,17,0,-17
8503,1,0,53,0,-53
8504,1,0,79,0,-79
8505,0,0,9,0,-9
8506,1,1,275,1324,1049
8507,1,0,24,0,-24
8508,0,0,45,0,-45
8509,1,1,670,1267,597
8510,0,0,29,0,-29
8511,0,0,2,0,-2
8512,1,1,522,1266,744
8513,1,0,2,0,-2
8514,1,0,28,0,-28
8515,0,0,85,0,-85
8516,0,0,14,0,-14
8517,0,0,47,0,-47
8518,1,0,75,0,-75
8519,1,0,68,0,-68
8520,0,0,146,0,-146
8521,0,0,27,0,-27
8522,0,0,62,0,-62
8523,1,0,0,0,0
8524,1,1,279,1459,1180
8525,0,0,4,0,-4
8526,1,0,138,0,-138
8527,1,0,18,0,-18
8528,0,0,18,0,-18
8529,1,1,724,1227,503
8530,1,0,39,0,-39
8531,1,1,206,1290,1084
8532,0,0,36,0,-36
8533,0,0,0,0,0
8534,0,0,9,0,-9
8535,1,0,50,0,-50
8536,0,0,144,0,-144
8537,0,0,40,0,-40
8538,0,0,73,0,-73
8539,1,0,14,0,-14
8540,0,0,6,0,-6
8541,0,0,19,0,-19
8542,1,0,6,0,-6
8543,1,0,78,0,-78
8544,1,0,12,0,-12
8545,1,0,24,0,-24
8546,0,0,16,0,-16
8547,0,0,37,0,-37
8548,0,0,46,0,-46
8549,1,0,1,0,-1
8550,0,0,68,0,-68
8551,0,0,16,0,-16
8552,0,0,29,0,-29
8553,1,0,47,0,-47
8554,1,1,545,1549,1004
8555,0,0,4,0,-4
8556,1,1,305,1731,1426
8557,1,0,51,0,-51
8558,0,0,5,0,-5
8559,1,1,153,1295,1142
8560,1,0,80,0,-80
8561,1,0,10,0,-10
8562,1,1,437,1750,1313
8563,1,1,58,1631,1573
8564,1,1,130,1444,1314
8565,0,0,89,0,-89
8566,0,0,120,0,-120
8567,1,1,218,1391,1173
8568,1,1,935,1223,288
8569,1,0,30,0,-30
8570,0,0,26,0,-26
8571,0,0,2,0,-2
8572,0,0,33,0,-33
8573,1,0,50,0,-50
8574,0,0,18,0,-18
8575,0,0,21,0,-21
8576,1,1,144,1747,1603
8577,1,1,461,1368,907
8578,0,0,21,0,-21
8579,1,1,807,1765,958
8580,0,0,18,0,-18
8581,0,0,6,0,-6
8582,1,0,13,0,-13
8583,1,0,102,0,-102
8584,0,0,5,0,-5
8585,0,0,12,0,-12
8586,1,1,243,1442,1199
8587,1,0,16,0,-16
8588,1,0,2,0,-2
8589,0,0,152,0,-152
8590,1,0,30,0,-30
8591,1,0,0,0,0
8592,1,0,2,0,-2
8593,0,0,90,0,-90
8594,1,1,1535,1238,-297
8595,1,1,611,1592,981
8596,0,0,36,0,-36
8597,1,1,72,1416,1344
8598,1,0,62,0,-62
8599,1,1,356,2075,1719
8600,0,0,17,0,-17
8601,0,0,52,0,-52
8602,1,0,0,0,0
8603,0,0,70,0,-70
8604,1,1,121,1357,1236
8605,1,0,79,0,-79
8606,1,0,38,0,-38
8607,0,0,95,0,-95
8608,0,0,24,0,-24
8609,0,0,90,0,-90
8610,1,0,29,0,-29
8611,0,0,20,0,-20
8612,1,0,10,0,-10
8613,0,0,8,0,-8
8614,0,0,31,0,-31
8615,0,0,61,0,-61
8616,1,0,138,0,-138
8617,0,0,27,0,-27
8618,0,0,47,0,-47
8619,1,0,18,0,-18
8620,0,0,76,0,-76
8621,1,0,249,0,-249
8622,1,0,13,0,-13
8623,1,1,197,1304,1107
8624,1,1,75,1205,1130
8625,0,0,2,0,-2
8626,0,0,69,0,-69
8627,1,0,22,0,-22
8628,0,0,17,0,-17
8629,0,0,134,0,-134
8630,1,0,88,0,-88
8631,0,0,30,0,-30
8632,1,1,1148,1425,277
8633,0,0,46,0,-46
8634,1,1,229,1307,1078
8635,0,0,65,0,-65
8636,1,1,131,1347,1216
8637,1,0,9,0,-9
8638,0,0,11,0,-11
8639,1,1,262,1265,1003
8640,0,0,28,0,-28
8641,1,1,1156,5566,4410
8642,1,1,220,1248,1028
8643,0,0,3,0,-3
8644,0,0,124,0,-124
8645,0,0,3,0,-3
8646,1,0,15,0,-15
8647,1,1,811,1465,654
8648,1,1,152,1339,1187
8649,1,0,26,0,-26
8650,0,0,42,0,-42
8651,1,1,333,1333,1000
8652,1,1,951,1691,740
8653,1,1,249,1901,1652
8654,1,1,200,1649,1449
8655,0,0,12,0,-12
8656,1,1,175,2077,1902
8657,1,0,30,0,-30
8658,0,0,7,0,-7
8659,0,0,12,0,-12
8660,1,0,19,0,-19
8661,1,0,57,0,-57
8662,0,0,29,0,-29
8663,1,0,9,0,-9
8664,0,0,57,0,-57
8665,1,0,3,0,-3
8666,0,0,95,0,-95
8667,0,0,156,0,-156
8668,1,1,1293,1351,58
8669,1,1,301,1782,1481
8670,1,1,1157,1287,130
8671,1,0,107,0,-107
8672,1,1,857,1397,540
8673,0,0,96,0,-96
8674,1,0,35,0,-35
8675,1,1,132,1711,1579
8676,1,0,10,0,-10
8677,1,0,94,0,-94
8678,0,0,9,0,-9
8679,1,1,373,1810,1437
8680,1,1,189,1207,1018
8681,1,1,384,1763,1379
8682,1,1,219,1214,995
8683,0,0,94,0,-94
8684,1,1,1651,1443,-208
8685,1,0,3,0,-3
8686,1,1,31,1641,1610
8687,0,0,38,0,-38
8688,1,0,31,0,-31
8689,1,1,454,1773,1319
8690,1,1,50,1293,1243
8691,1,0,21,0,-21
8692,1,0,12,0,-12
8693,0,0,53,0,-53
8694,1,0,202,0,-202
8695,1,1,538,1481,943
8696,1,0,5,0,-5
8697,1,1,408,1423,1015
8698,0,0,16,0,-16
8699,1,1,351,1382,1031
8700,1,0,71,0,-71
8701,1,1,374,1762,1388
8702,0,0,6,0,-6
8703,1,1,475,1970,1495
8704,0,0,5,0,-5
8705,0,0,155,0,-155
8706,0,0,85,0,-85
8707,1,0,69,0,-69
8708,0,0,0,0,0
8709,0,0,15,0,-15
8710,0,0,9,0,-9
8711,1,0,71,0,-71
8712,0,0,14,0,-14
8713,0,0,42,0,-42
8714,0,0,53,0,-53
8715,1,1,426,1656,1230
8716,0,0,55,0,-55
8717,1,0,65,0,-65
8718,0,0,39,0,-39
8719,1,0,62,0,-62
8720,0,0,71,0,-71
8721,0,0,34,0,-34
8722,1,0,35,0,-35
8723,0,0,29,0,-29
8724,1,1,347,1255,908
8725,1,1,66,1326,1260
8726,1,1,78,1387,1309
8727,0,0,3,0,-3
8728,0,0,68,0,-68
8729,0,0,9,0,-9
8730,0,0,14,0,-14
8731,1,1,225,1267,1042
8732,0,0,128,0,-128
8733,0,0,25,0,-25
8734,1,1,273,1464,1191
8735,1,1,272,2197,1925
8736,1,1,832,1344,512
8737,0,0,5,0,-5
8738,1,1,173,1283,1110
8739,0,0,2,0,-2
8740,1,0,12,0,-12
8741,1,1,563,1270,707
8742,0,0,74,0,-74
8743,1,1,647,1223,576
8744,1,1,637,1489,852
8745,0,0,78,0,-78
8746,1,0,159,0,-159
8747,1,0,174,0,-174
8748,1,1,359,1560,1201
8749,1,0,24,0,-24
8750,1,1,793,1244,451
8751,1,0,2,0,-2
8752,1,0,9,0,-9
8753,0,0,5,0,-5
8754,1,0,51,0,-51
8755,1,0,45,0,-45
8756,1,0,53,0,-53
8757,0,0,104,0,-104
8758,0,0,48,0,-48
8759,1,0,13,0,-13
8760,0,0,13,0,-13
8761,0,0,7,0,-7
8762,1,0,0,0,0
8763,1,1,129,1466,1337
8764,0,0,101,0,-101
8765,1,1,196,1393,1197
8766,1,0,6,0,-6
8767,1,1,507,1335,828
8768,1,1,117,1520,1403
8769,1,1,160,1430,1270
8770,1,0,6,0,-6
8771,1,1,158,1209,1051
8772,0,0,28,0,-28
8773,0,0,46,0,-46
8774,1,1,36,1323,1287
8775,0,0,26,0,-26
8776,0,0,59,0,-59
8777,1,1,65,1430,1365
8778,1,1,673,3862,3189
8779,1,1,157,1864,1707
8780,0,0,2,0,-2
8781,1,0,13,0,-13
8782,1,1,842,1545,703
8783,0,0,62,0,-62
8784,1,0,54,0,-54
8785,1,1,363,1486,1123
8786,1,0,121,0,-121
8787,0,0,121,0,-121
8788,1,1,65,1522,1457
8789,1,0,123,0,-123
8790,1,1,1116,1557,441
8791,1,1,62,1911,1849
8792,1,0,7,0,-7
8793,0,0,16,0,-16
8794,1,1,235,1407,1172
8795,1,1,717,2124,1407
8796,0,0,18,0,-18
8797,0,0,39,0,-39
8798,1,1,150,2420,2270
8799,1,1,652,1505,853
8800,1,0,6,0,-6
8801,1,1,583,1858,1275
8802,1,1,227,1226,999
8803,0,0,132,0,-132
8804,0,0,24,0,-24
8805,0,0,65,0,-65
8806,1,1,409,1484,1075
8807,0,0,64,0,-64
8808,0,0,23,0,-23
8809,1,0,31,0,-31
8810,1,1,454,1219,765
8811,1,0,17,0,-17
8812,0,0,39,0,-39
8813,1,0,29,0,-29
8814,0,0,15,0,-15
8815,1,1,622,1462,840
8816,0,0,124,0,-124
8817,0,0,37,0,-37
8818,1,1,949,3041,2092
8819,1,0,33,0,-33
8820,1,1,363,1378,1015
8821,0,0,17,0,-17
8822,1,0,9,0,-9
8823,1,1,826,1413,587
8824,0,0,56,0,-56
8825,0,0,104,0,-104
8826,1,0,12,0,-12
8827,1,0,32,0,-32
8828,0,0,8,0,-8
8829,0,0,56,0,-56
8830,1,1,218,1207,989
8831,1,0,37,0,-37
8832,1,0,70,0,-70
8833,1,0,28,0,-28
8834,1,1,211,1402,1191
8835,0,0,125,0,-125
8836,0,0,109,0,-109
8837,0,0,11,0,-11
8838,0,0,17,0,-17
8839,1,1,1054,1268,214
8840,0,0,36,0,-36
8841,1,1,231,1288,1057
8842,1,0,59,0,-59
8843,1,0,78,0,-78
8844,1,0,6,0,-6
8845,1,0,86,0,-86
8846,0,0,21,0,-21
8847,0,0,72,0,-72
8848,1,1,36,1228,1192
8849,1,1,179,1854,1675
8850,1,0,9,0,-9
8851,0,0,120,0,-120
8852,0,0,49,0,-49
8853,0,0,31,0,-31
8854,0,0,7,0,-7
8855,1,1,452,1316,864
8856,0,0,147,0,-147
8857,1,0,29,0,-29
8858,1,0,87,0,-87
8859,0,0,41,0,-41
8860,1,1,516,1218,702
8861,0,0,15,0,-15
8862,1,0,21,0,-21
8863,1,0,50,0,-50
8864,0,0,53,0,-53
8865,1,0,217,0,-217
8866,0,0,6,0,-6
8867,0,0,116,0,-116
8868,0,0,27,0,-27
8869,1,1,1936,1441,-495
8870,0,0,6,0,-6
8871,0,0,23,0,-23
8872,0,0,6,0,-6
8873,1,1,130,2032,1902
8874,1,1,90,1203,1113
8875,1,1,109,1580,1471
8876,0,0,28,0,-28
8877,1,1,367,1630,1263
8878,1,0,25,0,-25
8879,0,0,0,0,0
8880,0,0,195,0,-195
8881,1,0,77,0,-77
8882,0,0,12,0,-12
8883,1,0,4,0,-4
8884,1,1,1001,1753,752
8885,1,1,1050,1206,156
8886,1,1,1210,1399,189
8887,0,0,31,0,-31
8888,1,1,731,1604,873
8889,1,0,9,0,-9
8890,1,0,43,0,-43
8891,1,1,30,1275,1245
8892,1,0,25,0,-25
8893,1,1,637,1243,606
8894,0,0,122,0,-122
8895,0,0,25,0,-25
8896,1,1,563,1641,1078
8897,0,0,66,0,-66
8898,1,1,852,1441,589
8899,1,0,113,0,-113
8900,1,0,5,0,-5
8901,1,0,120,0,-120
8902,1,1,172,2478,2306
8903,1,0,25,0,-25
8904,1,0,41,0,-41
8905,0,0,25,0,-25
8906,0,0,289,0,-289
8907,0,0,97,0,-97
8908,1,0,183,0,-183
8909,0,0,96,0,-96
8910,1,1,186,1208,1022
8911,1,0,56,0,-56
8912,0,0,15,0,-15
8913,1,0,38,0,-38
8914,0,0,23,0,-23
8915,0,0,85,0,-85
8916,1,1,796,2246,1450
8917,1,0,96,0,-96
8918,1,1,646,1608,962
8919,1,0,26,0,-26
8920,0,0,93,0,-93
8921,0,0,27,0,-27
8922,1,1,585,1445,860
8923,1,1,565,1425,860
8924,1,1,439,1495,1056
8925,1,0,123,0,-123
8926,0,0,7,0,-7
8927,1,0,94,0,-94
8928,1,0,83,0,-83
8929,1,1,1270,1265,-5
8930,0,0,22,0,-22
8931,0,0,48,0,-48
8932,0,0,41,0,-41
8933,0,0,205,0,-205
8934,0,0,111,0,-111
8935,1,1,159,2073,1914
8936,1,0,184,0,-184
8937,0,0,7,0,-7
8938,0,0,23,0,-23
8939,0,0,50,0,-50
8940,0,0,70,0,-70
8941,1,0,8,0,-8
8942,1,0,122,0,-122
8943,0,0,20,0,-20
8944,1,1,1517,2783,1266
8945,1,1,164,1258,1094
8946,0,0,37,0,-37
8947,0,0,0,0,0
8948,0,0,156,0,-156
8949,1,0,169,0,-169
8950,1,1,103,1453,1350
8951,1,1,987,1241,254
8952,1,0,67,0,-67
8953,1,0,77,0,-77
8954,1,1,354,1405,1051
8955,0,0,42,0,-42
8956,0,0,93,0,-93
8957,0,0,41,0,-41
8958,1,1,85,1696,1611
8959,1,0,106,0,-106
8960,0,0,1,0,-1
8961,1,1,600,1386,786
8962,1,1,310,1871,1561
8963,1,0,14,0,-14
8964,1,0,11,0,-11
8965,1,1,2039,1279,-760
8966,0,0,54,0,-54
8967,0,0,42,0,-42
8968,1,0,0,0,0
8969,0,0,61,0,-61
8970,1,1,83,1625,1542
8971,1,0,76,0,-76
8972,1,1,513,1281,768
8973,1,0,19,0,-19
8974,0,0,101,0,-101
8975,1,0,105,0,-105
8976,1,1,280,1362,1082
8977,1,1,457,1269,812
8978,1,1,127,1218,1091
8979,0,0,4,0,-4
8980,0,0,0,0,0
8981,0,0,50,0,-50
8982,0,0,84,0,-84
8983,1,0,12,0,-12
8984,0,0,7,0,-7
8985,1,1,590,1214,624
8986,1,1,824,1790,966
8987,0,0,188,0,-188
8988,1,0,120,0,-120
8989,1,1,1460,1246,-214
8990,0,0,76,0,-76
8991,0,0,71,0,-71
8992,0,0,45,0,-45
8993,0,0,171,0,-171
8994,1,0,22,0,-22
8995,0,0,32,0,-32
8996,1,0,82,0,-82
8997,0,0,84,0,-84
8998,1,0,11,0,-11
8999,0,0,102,0,-102
9000,0,0,21,0,-21
9001,0,0,16,0,-16
9002,0,0,91,0,-91
9003,1,0,11,0,-11
9004,1,1,923,1332,409
9005,1,0,21,0,-21
9006,0,0,22,0,-22
9007,0,0,29,0,-29
9008,1,1,295,1322,1027
9009,0,0,20,0,-20
9010,0,0,9,0,-9
9011,1,1,114,1368,1254
9012,1,0,3,0,-3
9013,0,0,16,0,-16
9014,0,0,130,0,-130
9015,1,1,2135,2227,92
9016,1,0,0,0,0
9017,1,1,58,1552,1494
9018,0,0,48,0,-48
9019,0,0,107,0,-107
9020,0,0,55,0,-55
9021,0,0,296,0,-296
9022,1,0,98,0,-98
9023,1,0,62,0,-62
9024,1,0,158,0,-158
9025,1,1,563,1657,1094
9026,1,1,958,1296,338
9027,0,0,54,0,-54
9028,1,1,987,1369,382
9029,0,0,31,0,-31
9030,1,1,732,1679,947
9031,0,0,102,0,-102
9032,0,0,79,0,-79
9033,0,0,43,0,-43
9034,1,1,993,1579,586
9035,0,0,2,0,-2
9036,1,0,5,0,-5
9037,1,1,930,1218,288
9038,1,0,20,0,-20
9039,0,0,38,0,-38
9040,0,0,67,0,-67
9041,0,0,8,0,-8
9042,0,0,31,0,-31
9043,1,1,314,1258,944
9044,1,1,343,1685,1342
9045,0,0,2,0,-2
9046,1,1,484,1805,1321
9047,1,0,6,0,-6
9048,1,1,652,1488,836
9049,1,1,263,1686,1423
9050,1,0,91,0,-91
9051,1,1,801,1280,479
9052,0,0,59,0,-59
9053,1,0,237,0,-237
9054,0,0,2,0,-2
9055,1,1,179,1308,1129
9056,0,0,59,0,-59
9057,1,1,83,1281,1198
9058,0,0,199,0,-199
9059,0,0,6,0,-6
9060,1,0,3,0,-3
9061,1,1,1335,2333,998
9062,0,0,66,0,-66
9063,1,1,344,2610,2266
9064,1,1,110,1206,1096
9065,1,0,21,0,-21
9066,1,0,57,0,-57
9067,0,0,33,0,-33
9068,1,0,30,0,-30
9069,1,0,36,0,-36
9070,0,0,51,0,-51
9071,1,1,214,1407,1193
9072,0,0,0,0,0
9073,0,0,53,0,-53
9074,1,1,1045,1333,288
9075,1,1,247,1382,1135
9076,0,0,21,0,-21
9077,0,0,10,0,-10
9078,1,1,216,1318,1102
9079,1,0,45,0,-45
9080,1,1,139,1574,1435
9081,0,0,14,0,-14
9082,1,0,54,0,-54
9083,1,0,0,0,0
9084,0,0,60,0,-60
9085,0,0,39,0,-39
9086,1,1,2060,1300,-760
9087,1,0,55,0,-55
9088,0,0,10,0,-10
9089,1,1,716,1342,626
9090,0,0,55,0,-55
9091,0,0,11,0,-11
9092,1,1,1023,2832,1809
9093,0,0,2,0,-2
9094,0,0,31,0,-31
9095,0,0,69,0,-69
9096,1,0,103,0,-103
9097,1,1,409,1410,1001
9098,1,0,38,0,-38
9099,0,0,121,0,-121
9100,0,0,53,0,-53
9101,1,0,11,0,-11
9102,0,0,11,0,-11
9103,1,1,37,1326,1289
9104,0,0,51,0,-51
9105,0,0,104,0,-104
9106,0,0,50,0,-50
9107,1,1,300,2540,2240
9108,1,0,95,0,-95
9109,1,0,63,0,-63
9110,0,0,86,0,-86
9111,1,0,123,0,-123
9112,1,1,508,1246,738
9113,0,0,134,0,-134
9114,0,0,15,0,-15
9115,1,0,124,0,-124
9116,1,1,708,2212,1504
9117,0,0,24,0,-24
9118,1,0,9,0,-9
9119,1,0,14,0,-14
9120,0,0,5,0,-5
9121,1,0,37,0,-37
9122,1,1,353,1535,1182
9123,0,0,113,0,-113
9124,1,1,954,1743,789
9125,1,1,571,1506,935
9126,1,0,14,0,-14
9127,0,0,16,0,-16
9128,1,1,637,1279,642
9129,1,1,1455,1339,-116
9130,0,0,11,0,-11
9131,0,0,1,0,-1
9132,0,0,27,0,-27
9133,0,0,18,0,-18
9134,1,0,2,0,-2
9135,1,0,58,0,-58
9136,1,1,498,1346,848
9137,0,0,30,0,-30
9138,0,0,83,0,-83
9139,1,1,165,1497,1332
9140,1,1,148,1573,1425
9141,1,1,354,1774,1420
9142,1,1,343,7576,7233
9143,0,0,28,0,-28
9144,0,0,13,0,-13
9145,1,0,35,0,-35
9146,1,0,24,0,-24
9147,1,0,183,0,-183
9148,1,0,51,0,-51
9149,0,0,4,0,-4
9150,1,1,355,1302,947
9151,1,0,5,0,-5
9152,1,1,143,1430,1287
9153,1,0,87,0,-87
9154,1,0,97,0,-97
9155,0,0,44,0,-44
9156,0,0,170,0,-170
9157,1,0,7,0,-7
9158,1,1,77,1512,1435
9159,0,0,31,0,-31
9160,1,1,322,1208,886
9161,0,0,185,0,-185
9162,0,0,35,0,-35
9163,1,0,23,0,-23
9164,1,1,142,1235,1093
9165,1,0,25,0,-25
9166,1,0,87,0,-87
9167,1,1,750,1843,1093
9168,1,1,1550,1342,-208
9169,0,0,23,0,-23
9170,1,1,738,1236,498
9171,1,1,545,1515,970
9172,0,0,190,0,-190
9173,1,1,216,1621,1405
9174,1,1,1238,1210,-28
9175,0,0,7,0,-7
9176,0,0,26,0,-26
9177,0,0,27,0,-27
9178,1,1,266,1219,953
9179,0,0,59,0,-59
9180,1,0,59,0,-59
9181,0,0,12,0,-12
9182,0,0,28,0,-28
9183,1,0,12,0,-12
9184,0,0,40,0,-40
9185,0,0,9,0,-9
9186,1,1,648,1354,706
9187,1,1,267,1266,999
9188,0,0,117,0,-117
9189,0,0,69,0,-69
9190,0,0,52,0,-52
9191,1,0,10,0,-10
9192,1,0,38,0,-38
9193,0,0,54,0,-54
9194,0,0,33,0,-33
9195,0,0,94,0,-94
9196,0,0,18,0,-18
9197,1,0,28,0,-28
9198,0,0,25,0,-25
9199,0,0,0,0,0
9200,1,0,1,0,-1
9201,1,0,67,0,-67
9202,1,0,34,0,-34
9203,1,0,22,0,-22
9204,1,0,91,0,-91
9205,1,1,44,1435,1391
9206,1,1,454,1546,1092
9207,1,1,435,1256,821
9208,0,0,33,0,-33
9209,1,0,11,0,-11
9210,0,0,7,0,-7
9211,1,0,84,0,-84
9212,1,0,5,0,-5
9213,1,0,3,0,-3
9214,1,1,1372,1592,220
9215,0,0,49,0,-49
9216,1,1,181,1399,1218
9217,1,1,290,1254,964
9218,0,0,109,0,-109
9219,1,1,234,1650,1416
9220,1,1,268,1252,984
9221,0,0,113,0,-113
9222,0,0,60,0,-60
9223,1,0,33,0,-33
9224,1,1,148,1280,1132
9225,0,0,28,0,-28
9226,0,0,51,0,-51
9227,1,1,464,1494,1030
9228,1,0,123,0,-123
9229,1,0,84,0,-84
9230,1,0,22,0,-22
9231,1,1,61,1238,1177
9232,1,1,1301,1246,-55
9233,1,0,40,0,-40
9234,0,0,81,0,-81
9235,1,0,8,0,-8
9236,0,0,45,0,-45
9237,1,0,7,0,-7
9238,0,0,91,0,-91
9239,1,0,21,0,-21
9240,0,0,11,0,-11
9241,1,1,420,1928,1508
9242,1,0,150,0,-150
9243,1,1,568,1274,706
9244,1,0,27,0,-27
9245,1,0,0,0,0
9246,0,0,26,0,-26
9247,1,1,344,1376,1032
9248,1,0,46,0,-46
9249,1,1,170,2013,1843
9250,1,1,533,2185,1652
9251,0,0,138,0,-138
9252,1,1,545,1543,998
9253,1,1,224,1410,1186
9254,1,0,73,0,-73
9255,0,0,24,0,-24
9256,0,0,9,0,-9
9257,0,0,6,0,-6
9258,0,0,9,0,-9
9259,0,0,64,0,-64
9260,0,0,83,0,-83
9261,1,1,740,1243,503
9262,1,1,278,2033,1755
9263,1,0,68,0,-68
9264,1,1,592,1574,982
9265,1,0,25,0,-25
9266,0,0,61,0,-61
9267,1,0,79,0,-79
9268,0,0,39,0,-39
9269,1,0,58,0,-58
9270,1,0,23,0,-23
9271,1,1,751,1827,1076
9272,1,1,93,1427,1334
9273,1,0,68,0,-68
9274,0,0,20,0,-20
9275,0,0,22,0,-22
9276,1,0,16,0,-16
9277,1,1,1617,1661,44
9278,0,0,221,0,-221
9279,1,0,56,0,-56
9280,1,1,894,1230,336
9281,1,1,88,1464,1376
9282,0,0,7,0,-7
9283,1,1,540,1251,711
9284,0,0,39,0,-39
9285,1,0,69,0,-69
9286,1,1,300,1588,1288
9287,0,0,14,0,-14
9288,1,1,57,1257,1200
9289,0,0,63,0,-63
9290,0,0,1,0,-1
9291,0,0,36,0,-36
9292,0,0,75,0,-75
9293,0,0,71,0,-71
9294,1,0,49,0,-49
9295,0,0,47,0,-47
9296,1,0,70,0,-70
9297,0,0,48,0,-48
9298,0,0,25,0,-25
9299,1,0,101,0,-101
9300,0,0,170,0,-170
9301,1,1,94,3087,2993
9302,0,0,67,0,-67
9303,0,0,14,0,-14
9304,0,0,10,0,-10
9305,1,1,129,1436,1307
9306,0,0,67,0,-67
9307,0,0,32,0,-32
9308,0,0,64,0,-64
9309,1,0,88,0,-88
9310,1,0,4,0,-4
9311,0,0,24,0,-24
9312,0,0,10,0,-10
9313,1,0,43,0,-43
9314,0,0,3,0,-3
9315,0,0,34,0,-34
9316,0,0,42,0,-42
9317,1,0,0,0,0
9318,0,0,87,0,-87
9319,1,0,26,0,-26
9320,1,0,13,0,-13
9321,0,0,79,0,-79
9322,1,0,73,0,-73
9323,1,0,5,0,-5
9324,0,0,4,0,-4
9325,0,0,83,0,-83
9326,0,0,86,0,-86
9327,0,0,202,0,-202
9328,0,0,59,0,-59
9329,1,1,337,1298,961
9330,1,0,10,0,-10
9331,0,0,88,0,-88
9332,1,1,350,1632,1282
9333,0,0,46,0,-46
9334,1,0,85,0,-85
9335,1,0,56,0,-56
9336,1,0,19,0,-19
9337,1,1,44,1303,1259
9338,1,1,326,1536,1210
9339,0,0,0,0,0
9340,1,1,211,1286,1075
9341,1,1,299,1373,1074
9342,0,0,125,0,-125
9343,0,0,226,0,-226
9344,1,0,0,0,0
9345,1,1,114,1569,1455
9346,1,0,20,0,-20
9347,1,0,61,0,-61
9348,1,0,4,0,-4
9349,0,0,56,0,-56
9350,1,1,157,2215,2058
9351,0,0,129,0,-129
9352,1,1,446,1786,1340
9353,1,1,473,1560,1087
9354,1,1,109,1471,1362
9355,1,0,89,0,-89
9356,0,0,44,0,-44
9357,1,1,211,1249,1038
9358,1,1,546,1246,700
9359,1,1,353,2879,2526
9360,1,0,130,0,-130
9361,0,0,37,0,-37
9362,1,1,1323,1371,48
9363,1,0,19,0,-19
9364,0,0,13,0,-13
9365,0,0,24,0,-24
9366,1,0,0,0,0
9367,1,1,452,1265,813
9368,0,0,36,0,-36
9369,0,0,136,0,-136
9370,1,0,5,0,-5
9371,1,0,61,0,-61
9372,0,0,77,0,-77
9373,1,1,239,1608,1369
9374,1,0,5,0,-5
9375,1,0,0,0,0
9376,0,0,61,0,-61
9377,1,0,50,0,-50
9378,1,0,45,0,-45
9379,0,0,41,0,-41
9380,1,1,280,1201,921
9381,1,1,935,1281,346
9382,0,0,14,0,-14
9383,1,0,31,0,-31
9384,1,1,238,1851,1613
9385,0,0,55,0,-55
9386,1,0,69,0,-69
9387,0,0,198,0,-198
9388,0,0,129,0,-129
9389,0,0,26,0,-26
9390,1,1,551,2188,1637
9391,0,0,14,0,-14
9392,1,1,1324,1326,2
9393,0,0,9,0,-9
9394,1,1,94,1250,1156
9395,1,0,22,0,-22
9396,0,0,215,0,-215
9397,1,1,465,2181,1716
9398,0,0,4,0,-4
9399,0,0,15,0,-15
9400,1,1,112,3829,3717
9401,0,0,17,0,-17
9402,1,1,91,1851,1760
9403,1,0,65,0,-65
9404,1,1,1421,1582,161
9405,0,0,3,0,-3
9406,1,0,32,0,-32
9407,0,0,153,0,-153
9408,1,0,39,0,-39
9409,1,1,1930,1344,-586
9410,0,0,4,0,-4
9411,1,0,147,0,-147
9412,1,0,16,0,-16
9413,0,0,56,0,-56
9414,0,0,37,0,-37
9415,1,0,134,0,-134
9416,0,0,70,0,-70
9417,1,0,14,0,-14
9418,1,1,740,1326,586
9419,0,0,2,0,-2
9420,1,0,11,0,-11
9421,0,0,171,0,-171
9422,0,0,14,0,-14
9423,0,0,85,0,-85
9424,1,0,8,0,-8
9425,1,1,385,2014,1629
9426,1,1,261,1472,1211
9427,0,0,73,0,-73
9428,1,0,3,0,-3
9429,1,0,4,0,-4
9430,1,0,34,0,-34
9431,0,0,0,0,0
9432,1,0,46,0,-46
9433,0,0,100,0,-100
9434,1,0,25,0,-25
9435,1,1,1782,2379,597
9436,1,0,43,0,-43
9437,0,0,19,0,-19
9438,1,1,545,1382,837
9439,1,1,78,1540,1462
9440,1,0,1,0,-1
9441,1,1,142,1342,1200
9442,1,1,224,2634,2410
9443,1,0,5,0,-5
9444,0,0,55,0,-55
9445,1,0,65,0,-65
9446,1,0,66,0,-66
9447,1,0,26,0,-26
9448,1,0,65,0,-65
9449,1,1,329,2952,2623
9450,1,0,3,0,-3
9451,0,0,83,0,-83
9452,1,0,2,0,-2
9453,0,0,17,0,-17
9454,1,1,940,3210,2270
9455,1,1,555,1322,767
9456,0,0,105,0,-105
9457,1,1,460,1362,902
9458,1,0,15,0,-15
9459,0,0,31,0,-31
9460,1,0,15,0,-15
9461,0,0,6,0,-6
9462,0,0,28,0,-28
9463,1,0,7,0,-7
9464,0,0,31,0,-31
9465,0,0,197,0,-197
9466,1,0,48,0,-48
9467,0,0,120,0,-120
9468,1,0,5,0,-5
9469,1,1,480,1214,734
9470,0,0,44,0,-44
9471,0,0,41,0,-41
9472,0,0,7,0,-7
9473,1,1,112,1297,1185
9474,0,0,26,0,-26
9475,0,0,62,0,-62
9476,1,0,19,0,-19
9477,1,0,80,0,-80
9478,1,1,605,1229,624
9479,0,0,10,0,-10
9480,1,1,43,1254,1211
9481,0,0,65,0,-65
9482,0,0,16,0,-16
9483,0,0,141,0,-141
9484,0,0,24,0,-24
9485,1,1,336,1467,1131
9486,0,0,58,0,-58
9487,1,1,125,1447,1322
9488,0,0,68,0,-68
9489,0,0,6,0,-6
9490,0,0,18,0,-18
9491,1,0,87,0,-87
9492,1,1,1195,1733,538
9493,0,0,12,0,-12
9494,1,1,1172,1230,58
9495,0,0,19,0,-19
9496,1,1,723,1272,549
9497,1,0,62,0,-62
9498,1,0,26,0,-26
9499,1,1,586,1349,763
9500,1,0,47,0,-47
9501,1,1,171,1251,1080
9502,0,0,10,0,-10
9503,1,1,337,2261,1924
9504,0,0,46,0,-46
9505,0,0,12,0,-12
9506,0,0,103,0,-103
9507,0,0,14,0,-14
9508,0,0,50,0,-50
9509,0,0,98,0,-98
9510,1,1,117,2296,2179
9511,1,1,427,1209,782
9512,1,0,85,0,-85
9513,1,1,913,1257,344
9514,0,0,66,0,-66
9515,1,1,427,1385,958
9516,0,0,1,0,-1
9517,1,1,14,1228,1214
9518,0,0,44,0,-44
9519,1,1,452,1322,870
9520,1,1,96,1458,1362
9521,1,0,38,0,-38
9522,1,0,28,0,-28
9523,1,1,52,1248,1196
9524,1,1,170,1421,1251
9525,0,0,16,0,-16
9526,1,0,10,0,-10
9527,1,0,21,0,-21
9528,0,0,23,0,-23
9529,1,0,125,0,-125
9530,0,0,8,0,-8
9531,0,0,207,0,-207
9532,1,0,8,0,-8
9533,1,1,402,1261,859
9534,1,0,22,0,-22
9535,0,0,19,0,-19
9536,1,0,4,0,-4
9537,1,0,14,0,-14
9538,0,0,8,0,-8
9539,1,0,88,0,-88
9540,0,0,11,0,-11
9541,1,1,356,1218,862
9542,1,1,176,1741,1565
9543,0,0,37,0,-37
9544,0,0,49,0,-49
9545,0,0,42,0,-42
9546,1,1,179,1626,1447
9547,0,0,159,0,-159
9548,0,0,1,0,-1
9549,1,1,407,1560,1153
9550,1,1,590,1824,1234
9551,1,1,135,1778,1643
9552,0,0,29,0,-29
9553,0,0,68,0,-68
9554,1,1,66,1496,1430
9555,1,1,308,1232,924
9556,1,1,107,1734,1627
9557,0,0,86,0,-86
9558,1,0,6,0,-6
9559,1,1,347,1681,1334
9560,1,1,266,2209,1943
9561,0,0,98,0,-98
9562,1,0,96,0,-96
9563,0,0,232,0,-232
9564,1,0,49,0,-49
9565,0,0,21,0,-21
9566,1,1,596,2640,2044
9567,1,0,68,0,-68
9568,1,0,31,0,-31
9569,1,0,76,0,-76
9570,1,0,18,0,-18
9571,1,1,336,1257,921
9572,0,0,33,0,-33
9573,1,0,85,0,-85
9574,1,1,944,1538,594
9575,1,0,4,0,-4
9576,1,0,49,0,-49
9577,0,0,76,0,-76
9578,1,0,3,0,-3
9579,1,1,334,1281,947
9580,1,0,107,0,-107
9581,1,0,8,0,-8
9582,1,0,41,0,-41
9583,1,1,782,1743,961
9584,0,0,29,0,-29
9585,1,0,165,0,-165
9586,1,0,109,0,-109
9587,1,1,61,1263,1202
9588,0,0,35,0,-35
9589,0,0,29,0,-29
9590,0,0,1,0,-1
9591,1,1,83,1441,1358
9592,0,0,49,0,-49
9593,0,0,11,0,-11
9594,1,0,29,0,-29
9595,1,0,16,0,-16
9596,1,1,212,1270,1058
9597,1,1,617,1200,583
9598,0,0,81,0,-81
9599,0,0,126,0,-126
9600,1,1,38,1386,1348
9601,0,0,10,0,-10
9602,1,0,7,0,-7
9603,1,0,25,0,-25
9604,1,0,13,0,-13
9605,1,0,26,0,-26
9606,1,1,276,2318,2042
9607,0,0,1,0,-1
9608,1,1,165,1261,1096
9609,1,0,71,0,-71
9610,1,0,4,0,-4
9611,0,0,114,0,-114
9612,1,0,35,0,-35
9613,1,0,29,0,-29
9614,1,0,136,0,-136
9615,1,1,959,1729,770
9616,0,0,97,0,-97
9617,1,1,157,1239,1082
9618,0,0,6,0,-6
9619,0,0,14,0,-14
9620,1,1,472,1273,801
9621,0,0,2,0,-2
9622,0,0,22,0,-22
9623,1,0,6,0,-6
9624,1,0,31,0,-31
9625,0,0,0,0,0
9626,0,0,125,0,-125
9627,0,0,61,0,-61
9628,0,0,57,0,-57
9629,1,0,32,0,-32
9630,0,0,15,0,-15
9631,1,1,1605,1336,-269
9632,1,0,42,0,-42
9633,0,0,28,0,-28
9634,1,1,406,1668,1262
9635,0,0,75,0,-75
9636,0,0,26,0,-26
9637,1,0,18,0,-18
9638,0,0,75,0,-75
9639,1,0,44,0,-44
9640,1,1,448,1752,1304
9641,1,1,397,1301,904
9642,1,0,31,0,-31
9643,0,0,6,0,-6
9644,1,0,47,0,-47
9645,0,0,13,0,-13
9646,1,1,124,2009,1885
9647,0,0,67,0,-67
9648,1,1,2038,1837,-201
9649,0,0,59,0,-59
9650,0,0,19,0,-19
9651,1,0,107,0,-107
9652,1,1,287,1237,950
9653,0,0,40,0,-40
9654,0,0,59,0,-59
9655,1,1,287,1206,919
9656,1,1,402,1316,914
9657,1,1,278,1875,1597
9658,0,0,44,0,-44
9659,1,1,11,1528,1517
9660,0,0,28,0,-28
9661,0,0,35,0,-35
9662,0,0,140,0,-140
9663,1,0,33,0,-33
9664,1,0,28,0,-28
9665,1,0,28,0,-28
9666,0,0,20,0,-20
9667,0,0,183,0,-183
9668,1,0,60,0,-60
9669,0,0,17,0,-17
9670,1,0,61,0,-61
9671,1,1,209,2163,1954
9672,1,1,303,1556,1253
9673,0,0,5,0,-5
9674,1,1,173,1379,1206
9675,0,0,1,0,-1
9676,1,1,745,1532,787
9677,1,1,1286,1305,19
9678,0,0,2,0,-2
9679,0,0,7,0,-7
9680,0,0,10,0,-10
9681,0,0,11,0,-11
9682,0,0,21,0,-21
9683,1,0,245,0,-245
9684,0,0,51,0,-51
9685,1,0,39,0,-39
9686,0,0,88,0,-88
9687,1,0,2,0,-2
9688,0,0,31,0,-31
9689,1,1,61,1958,1897
9690,1,1,163,1363,1200
9691,0,0,52,0,-52
9692,0,0,24,0,-24
9693,1,1,457,1456,999
9694,1,1,786,1233,447
9695,1,0,4,0,-4
9696,0,0,6,0,-6
9697,0,0,102,0,-102
9698,1,0,142,0,-142
9699,1,1,381,1331,950
9700,0,0,18,0,-18
9701,0,0,7,0,-7
9702,0,0,20,0,-20
9703,0,0,43,0,-43
9704,1,1,883,2604,1721
9705,1,1,410,1688,1278
9706,0,0,9,0,-9
9707,1,1,180,1241,1061
9708,1,1,100,1666,1566
9709,0,0,44,0,-44
9710,1,1,334,1321,987
9711,0,0,53,0,-53
9712,1,0,15,0,-15
9713,1,0,26,0,-26
9714,1,0,0,0,0
9715,0,0,92,0,-92
9716,0,0,23,0,-23
9717,0,0,64,0,-64
9718,1,1,631,1232,601
9719,0,0,6,0,-6
9720,0,0,15,0,-15
9721,1,0,0,0,0
9722,0,0,12,0,-12
9723,0,0,73,0,-73
9724,0,0,60,0,-60
9725,0,0,33,0,-33
9726,1,1,398,1640,1242
9727,1,0,6,0,-6
9728,1,0,49,0,-49
9729,0,0,58,0,-58
9730,1,1,299,1224,925
9731,1,1,360,1223,863
9732,1,0,32,0,-32
9733,1,0,7,0,-7
9734,0,0,13,0,-13
9735,1,1,78,2004,1926
9736,1,0,9,0,-9
9737,0,0,66,0,-66
9738,1,1,500,2297,1797
9739,1,1,332,1597,1265
9740,1,1,197,1261,1064
9741,1,0,15,0,-15
9742,0,0,48,0,-48
9743,1,0,137,0,-137
9744,1,1,761,1293,532
9745,1,1,345,1836,1491
9746,1,0,36,0,-36
9747,0,0,105,0,-105
9748,0,0,54,0,-54
9749,1,0,29,0,-29
9750,1,0,62,0,-62
9751,0,0,116,0,-116
9752,0,0,43,0,-43
9753,0,0,47,0,-47
9754,1,1,392,1384,992
9755,1,1,567,1542,975
9756,0,0,223,0,-223
9757,0,0,16,0,-16
9758,1,1,783,1667,884
9759,1,1,532,1569,1037
9760,1,1,704,1202,498
9761,0,0,36,0,-36
9762,0,0,27,0,-27
9763,1,0,21,0,-21
9764,1,1,307,1714,1407
9765,1,1,1055,1530,475
9766,0,0,1,0,-1
9767,1,1,803,2157,1354
9768,0,0,143,0,-143
9769,1,1,385,1784,1399
9770,0,0,30,0,-30
9771,0,0,32,0,-32
9772,0,0,17,0,-17
9773,1,0,81,0,-81
9774,1,1,571,1392,821
9775,1,1,375,1708,1333
9776,1,0,23,0,-23
9777,0,0,43,0,-43
9778,0,0,70,0,-70
9779,1,0,20,0,-20
9780,1,1,1006,5441,4435
9781,0,0,3,0,-3
9782,1,0,132,0,-132
9783,1,1,968,1327,359
9784,1,0,49,0,-49
9785,0,0,7,0,-7
9786,1,1,163,1210,1047
9787,1,0,116,0,-116
9788,1,0,5,0,-5
9789,0,0,28,0,-28
9790,1,0,29,0,-29
9791,1,1,180,1473,1293
9792,0,0,54,0,-54
9793,1,0,223,0,-223
9794,0,0,27,0,-27
9795,1,0,93,0,-93
9796,1,0,139,0,-139
9797,1,0,0,0,0
9798,1,0,173,0,-173
9799,1,1,254,1761,1507
9800,1,1,73,2200,2127
9801,1,0,92,0,-92
9802,1,1,760,1507,747
9803,0,0,64,0,-64
9804,1,0,9,0,-9
9805,1,0,38,0,-38
9806,1,1,411,1289,878
9807,0,0,3,0,-3
9808,0,0,10,0,-10
9809,0,0,60,0,-60
9810,1,1,140,1702,1562
9811,0,0,163,0,-163
9812,1,1,704,1303,599
9813,0,0,34,0,-34
9814,1,0,47,0,-47
9815,1,0,22,0,-22
9816,1,1,152,1235,1083
9817,1,1,702,1204,502
9818,0,0,35,0,-35
9819,1,0,4,0,-4
9820,0,0,2,0,-2
9821,0,0,17,0,-17
9822,0,0,45,0,-45
9823,0,0,44,0,-44
9824,0,0,49,0,-49
9825,0,0,74,0,-74
9826,1,0,79,0,-79
9827,0,0,32,0,-32
9828,1,0,99,0,-99
9829,1,0,8,0,-8
9830,1,1,1445,1371,-74
9831,0,0,155,0,-155
9832,0,0,19,0,-19
9833,1,0,49,0,-49
9834,1,0,94,0,-94
9835,1,0,14,0,-14
9836,1,0,1,0,-1
9837,1,1,79,1292,1213
9838,0,0,134,0,-134
9839,1,0,34,0,-34
9840,1,1,505,1399,894
9841,1,1,76,2971,2895
9842,1,1,896,1925,1029
9843,1,0,5,0,-5
9844,0,0,58,0,-58
9845,1,0,50,0,-50
9846,1,1,1107,2374,1267
9847,0,0,12,0,-12
9848,1,0,9,0,-9
9849,1,1,716,1846,1130
9850,1,0,95,0,-95
9851,0,0,6,0,-6
9852,1,0,34,0,-34
9853,0,0,60,0,-60
9854,1,0,130,0,-130
9855,0,0,0,0,0
9856,0,0,56,0,-56
9857,0,0,83,0,-83
9858,0,0,74,0,-74
9859,0,0,23,0,-23
9860,1,1,292,1380,1088
9861,1,1,171,1233,1062
9862,1,1,875,1273,398
9863,0,0,46,0,-46
9864,1,1,162,1210,1048
9865,1,1,186,2376,2190
9866,0,0,136,0,-136
9867,1,1,401,2002,1601
9868,0,0,8,0,-8
9869,1,1,112,1219,1107
9870,0,0,58,0,-58
9871,1,1,459,1524,1065
9872,0,0,11,0,-11
9873,0,0,27,0,-27
9874,1,1,1592,1562,-30
9875,1,1,59,1826,1767
9876,1,0,42,0,-42
9877,0,0,7,0,-7
9878,1,1,211,1343,1132
9879,1,0,42,0,-42
9880,0,0,13,0,-13
9881,1,1,851,1393,542
9882,0,0,64,0,-64
9883,1,0,51,0,-51
9884,1,0,2,0,-2
9885,1,1,732,2439,1707
9886,1,0,22,0,-22
9887,1,0,16,0,-16
9888,0,0,195,0,-195
9889,0,0,57,0,-57
9890,1,1,10,1468,1458
9891,0,0,25,0,-25
9892,0,0,130,0,-130
9893,1,1,130,1381,1251
9894,1,0,41,0,-41
9895,1,0,18,0,-18
9896,0,0,20,0,-20
9897,0,0,13,0,-13
9898,1,0,20,0,-20
9899,0,0,49,0,-49
9900,1,1,84,1420,1336
9901,0,0,6,0,-6
9902,1,0,150,0,-150
9903,1,1,59,1354,1295
9904,0,0,120,0,-120
9905,1,0,60,0,-60
9906,0,0,14,0,-14
9907,0,0,99,0,-99
9908,1,1,760,2137,1377
9909,1,1,1751,2101,350
9910,0,0,56,0,-56
9911,0,0,8,0,-8
9912,1,0,29,0,-29
9913,1,1,186,2144,1958
9914,0,0,34,0,-34
9915,0,0,15,0,-15
9916,1,1,28,1475,1447
9917,1,1,235,1386,1151
9918,1,1,474,1409,935
9919,1,0,58,0,-58
9920,0,0,84,0,-84
9921,0,0,67,0,-67
9922,0,0,41,0,-41
9923,1,0,18,0,-18
9924,1,1,578,1210,632
9925,0,0,48,0,-48
9926,0,0,71,0,-71
9927,0,0,24,0,-24
9928,1,1,339,1209,870
9929,1,1,300,1214,914
9930,1,0,0,0,0
9931,1,1,704,1265,561
9932,0,0,3,0,-3
9933,0,0,34,0,-34
9934,1,1,366,1291,925
9935,1,1,332,1957,1625
9936,1,1,345,1474,1129
9937,1,0,7,0,-7
9938,1,1,588,1366,778
9939,0,0,80,0,-80
9940,0,0,9,0,-9
9941,0,0,40,0,-40
9942,1,1,683,1244,561
9943,0,0,192,0,-192
9944,0,0,60,0,-60
9945,1,0,17,0,-17
9946,0,0,2,0,-2
9947,1,1,361,1523,1162
9948,0,0,75,0,-75
9949,1,0,7,0,-7
9950,1,0,74,0,-74
9951,0,0,43,0,-43
9952,0,0,42,0,-42
9953,1,0,31,0,-31
9954,1,0,8,0,-8
9955,1,0,1,0,-1
9956,1,0,97,0,-97
9957,0,0,5,0,-5
9958,1,1,455,1237,782
9959,1,0,20,0,-20
9960,1,1,216,1739,1523
9961,0,0,69,0,-69
9962,1,0,43,0,-43
9963,0,0,12,0,-12
9964,0,0,42,0,-42
9965,1,0,58,0,-58
9966,1,0,21,0,-21
9967,1,0,1,0,-1
9968,0,0,2,0,-2
9969,1,0,43,0,-43
9970,0,0,3,0,-3
9971,1,0,77,0,-77
9972,0,0,53,0,-53
9973,1,0,74,0,-74
9974,1,1,1105,1674,569
9975,0,0,2,0,-2
9976,1,1,53,1391,1338
9977,0,0,31,0,-31
9978,1,1,689,1651,962
9979,0,0,3,0,-3
9980,1,0,34,0,-34
9981,1,0,22,0,-22
9982,1,1,169,1335,1166
9983,1,1,191,1443,1252
9984,0,0,65,0,-65
9985,0,0,22,0,-22
9986,1,1,479,1758,1279
9987,1,0,1,0,-1
9988,1,0,79,0,-79
9989,1,1,546,1217,671
9990,0,0,55,0,-55
9991,1,0,60,0,-60
9992,1,0,28,0,-28
9993,0,0,47,0,-47
9994,1,0,48,0,-48
9995,1,1,1044,1369,325
9996,0,0,64,0,-64
9997,0,0,48,0,-48
9998,0,0,68,0,-68
9999,0,0,75,0,-75
10000,1,1,31,1239,1208
10001,0,0,27,0,-27
10002,0,0,6,0,-6
10003,1,0,150,0,-150
10004,1,1,207,1438,1231
10005,0,0,5,0,-5
10006,1,1,246,1827,1581
10007,1,0,27,0,-27
10008,1,0,43,0,-43
10009,1,0,128,0,-128
10010,1,1,699,1323,624
10011,1,1,2018,2409,391
10012,1,1,327,1296,969
10013,1,1,311,1391,1080
10014,0,0,35,0,-35
10015,0,0,45,0,-45
10016,0,0,54,0,-54
10017,0,0,42,0,-42
10018,1,1,246,1413,1167
10019,1,0,67,0,-67
10020,1,1,51,1418,1367
10021,1,1,34,1705,1671
10022,0,0,72,0,-72
10023,0,0,97,0,-97
10024,0,0,23,0,-23
10025,0,0,24,0,-24
10026,1,0,48,0,-48
10027,1,0,0,0,0
10028,0,0,102,0,-102
10029,0,0,9,0,-9
10030,1,0,1,0,-1
10031,0,0,50,0,-50
10032,1,1,684,1461,777
10033,1,1,483,1251,768
10034,1,0,26,0,-26
10035,1,1,574,1325,751
10036,1,0,99,0,-99
10037,0,0,34,0,-34
10038,1,1,351,1329,978
10039,1,0,76,0,-76
10040,1,1,124,1379,1255
10041,0,0,43,0,-43
10042,0,0,132,0,-132
10043,1,1,166,1254,1088
10044,1,1,249,1311,1062
10045,1,0,53,0,-53
10046,1,0,104,0,-104
10047,1,0,102,0,-102
10048,0,0,63,0,-63
10049,0,0,58,0,-58
10050,1,1,184,1449,1265
10051,0,0,19,0,-19
10052,0,0,35,0,-35
10053,1,1,620,1621,1001
10054,0,0,23,0,-23
10055,1,0,25,0,-25
10056,0,0,53,0,-53
10057,1,1,115,1255,1140
10058,0,0,15,0,-15
10059,1,0,70,0,-70
10060,1,1,483,2404,1921
10061,1,0,68,0,-68
10062,0,0,197,0,-197
10063,1,1,652,1778,1126
10064,1,1,234,1332,1098
10065,0,0,32,0,-32
10066,0,0,54,0,-54
10067,0,0,1,0,-1
10068,1,0,82,0,-82
10069,1,1,435,1264,829
10070,0,0,7,0,-7
10071,1,1,983,1285,302
10072,0,0,32,0,-32
10073,1,0,21,0,-21
10074,0,0,44,0,-44
10075,0,0,7,0,-7
10076,1,0,13,0,-13
10077,1,0,19,0,-19
10078,1,0,43,0,-43
10079,0,0,87,0,-87
10080,1,1,175,1434,1259
10081,0,0,6,0,-6
10082,1,0,51,0,-51
10083,0,0,22,0,-22
10084,0,0,0,0,0
10085,1,1,63,2695,2632
10086,0,0,71,0,-71
10087,0,0,43,0,-43
10088,0,0,31,0,-31
10089,0,0,35,0,-35
10090,0,0,122,0,-122
10091,0,0,29,0,-29
10092,1,0,38,0,-38
10093,0,0,68,0,-68
10094,0,0,46,0,-46
10095,0,0,51,0,-51
10096,0,0,62,0,-62
10097,1,1,617,1203,586
10098,1,0,24,0,-24
10099,1,0,15,0,-15
10100,1,0,17,0,-17
10101,0,0,4,0,-4
10102,1,0,31,0,-31
10103,0,0,5,0,-5
10104,0,0,2,0,-2
10105,1,1,78,1452,1374
10106,1,0,39,0,-39
10107,0,0,16,0,-16
10108,0,0,39,0,-39
10109,0,0,82,0,-82
10110,0,0,5,0,-5
10111,1,0,4,0,-4
10112,1,1,658,1381,723
10113,0,0,21,0,-21
10114,0,0,10,0,-10
10115,1,1,265,1256,991
10116,1,0,45,0,-45
10117,1,0,3,0,-3
10118,1,0,52,0,-52
10119,1,1,38,1485,1447
10120,1,1,615,1296,681
10121,1,1,410,1902,1492
10122,1,1,254,1300,1046
10123,0,0,2,0,-2
10124,0,0,89,0,-89
10125,1,1,990,1651,661
10126,1,0,65,0,-65
10127,0,0,35,0,-35
10128,1,1,938,1373,435
10129,1,1,152,1209,1057
10130,0,0,126,0,-126
10131,1,0,80,0,-80
10132,1,0,6,0,-6
10133,1,0,10,0,-10
10134,1,1,1173,1226,53
10135,1,0,11,0,-11
10136,1,1,957,1229,272
10137,1,1,222,1239,1017
10138,1,1,40,4061,4021
10139,1,0,10,0,-10
10140,1,0,38,0,-38
10141,1,0,110,0,-110
10142,1,0,29,0,-29
10143,0,0,215,0,-215
10144,1,1,469,1211,742
10145,1,1,42,1202,1160
10146,0,0,289,0,-289
10147,1,1,515,1506,991
10148,0,0,110,0,-110
10149,1,0,17,0,-17
10150,1,0,102,0,-102
10151,1,1,1777,1439,-338
10152,0,0,17,0,-17
10153,0,0,69,0,-69
10154,1,1,57,1244,1187
10155,1,1,495,1729,1234
10156,0,0,7,0,-7
10157,0,0,52,0,-52
10158,0,0,116,0,-116
10159,1,0,43,0,-43
10160,0,0,40,0,-40
10161,0,0,84,0,-84
10162,0,0,26,0,-26
10163,1,1,438,2499,2061
10164,0,0,46,0,-46
10165,1,0,15,0,-15
10166,1,1,808,1260,452
10167,1,1,290,2171,1881
10168,1,1,301,1936,1635
10169,1,1,172,1215,1043
10170,1,1,410,1968,1558
10171,0,0,14,0,-14
10172,0,0,0,0,0
10173,1,0,43,0,-43
10174,1,0,49,0,-49
10175,0,0,107,0,-107
10176,1,1,958,1772,814
10177,1,0,105,0,-105
10178,0,0,45,0,-45
10179,1,1,489,1406,917
10180,1,1,349,1407,1058
10181,1,0,80,0,-80
10182,1,0,2,0,-2
10183,1,1,1151,1350,199
10184,0,0,24,0,-24
10185,0,0,77,0,-77
10186,1,1,1879,1363,-516
10187,0,0,58,0,-58
10188,1,0,217,0,-217
10189,0,0,100,0,-100
10190,1,0,108,0,-108
10191,0,0,31,0,-31
10192,1,0,123,0,-123
10193,1,1,68,1696,1628
10194,1,1,595,1588,993
10195,0,0,124,0,-124
10196,1,1,77,1327,1250
10197,0,0,5,0,-5
10198,1,0,125,0,-125
10199,0,0,9,0,-9
10200,1,0,56,0,-56
10201,1,0,35,0,-35
10202,0,0,69,0,-69
10203,0,0,18,0,-18
10204,1,1,157,1340,1183
10205,1,0,43,0,-43
10206,1,1,508,1344,836
10207,0,0,9,0,-9
10208,1,0,134,0,-134
10209,0,0,10,0,-10
10210,1,0,87,0,-87
10211,1,1,348,1252,904
10212,0,0,26,0,-26
10213,1,1,355,1231,876
10214,1,1,55,1564,1509
10215,0,0,58,0,-58
10216,0,0,113,0,-113
10217,1,0,106,0,-106
10218,1,1,1030,1465,435
10219,1,1,82,2728,2646
10220,0,0,111,0,-111
10221,1,1,132,1227,1095
10222,1,0,12,0,-12
10223,1,0,38,0,-38
10224,0,0,19,0,-19
10225,1,1,86,1370,1284
10226,1,0,24,0,-24
10227,1,1,354,1399,1045
10228,0,0,47,0,-47
10229,1,0,32,0,-32
10230,1,0,31,0,-31
10231,1,1,296,1820,1524
10232,1,0,14,0,-14
10233,1,1,440,1328,888
10234,1,0,62,0,-62
10235,0,0,69,0,-69
10236,1,1,2893,1385,-1508
10237,0,0,83,0,-83
10238,1,0,7,0,-7
10239,0,0,0,0,0
10240,1,1,1358,1207,-151
10241,1,1,2250,1368,-882
10242,0,0,17,0,-17
10243,1,0,5,0,-5
10244,1,0,28,0,-28
10245,0,0,4,0,-4
10246,0,0,0,0,0
10247,0,0,1,0,-1
10248,1,0,1,0,-1
10249,1,1,151,1864,1713
10250,0,0,16,0,-16
10251,0,0,3,0,-3
10252,1,0,69,0,-69
10253,1,0,7,0,-7
10254,0,0,5,0,-5
10255,0,0,23,0,-23
10256,0,0,131,0,-131
10257,1,1,484,1529,1045
10258,1,0,85,0,-85
10259,1,0,70,0,-70
10260,1,0,143,0,-143
10261,0,0,0,0,0
10262,1,0,86,0,-86
10263,1,0,202,0,-202
10264,0,0,3,0,-3
10265,1,0,114,0,-114
10266,0,0,37,0,-37
10267,1,1,319,1259,940
10268,1,0,19,0,-19
10269,1,0,69,0,-69
10270,0,0,53,0,-53
10271,0,0,23,0,-23
10272,1,1,155,1608,1453
10273,0,0,56,0,-56
10274,1,0,136,0,-136
10275,1,0,1,0,-1
10276,0,0,22,0,-22
10277,0,0,78,0,-78
10278,0,0,44,0,-44
10279,1,0,91,0,-91
10280,1,0,140,0,-140
10281,0,0,6,0,-6
10282,1,1,211,1328,1117
10283,0,0,28,0,-28
10284,1,0,1,0,-1
10285,1,0,116,0,-116
10286,0,0,85,0,-85
10287,0,0,17,0,-17
10288,1,1,1091,1330,239
10289,0,0,64,0,-64
10290,1,0,107,0,-107
10291,0,0,1,0,-1
10292,0,0,29,0,-29
10293,1,1,253,1412,1159
10294,1,0,39,0,-39
10295,0,0,0,0,0
10296,1,1,842,1489,647
10297,0,0,72,0,-72
10298,1,1,1091,1349,258
10299,1,1,106,1357,1251
10300,1,1,391,2484,2093
10301,0,0,26,0,-26
10302,0,0,4,0,-4
10303,0,0,33,0,-33
10304,1,1,159,1587,1428
10305,0,0,20,0,-20
10306,0,0,38,0,-38
10307,1,1,180,1514,1334
10308,1,0,105,0,-105
10309,0,0,39,0,-39
10310,1,1,292,2194,1902
10311,1,1,334,1696,1362
10312,1,0,120,0,-120
10313,1,0,53,0,-53
10314,1,1,1819,1559,-260
10315,0,0,15,0,-15
10316,1,1,763,1458,695
10317,1,1,681,1395,714
10318,1,1,204,5922,5718
10319,1,0,32,0,-32
10320,0,0,33,0,-33
10321,0,0,67,0,-67
10322,0,0,100,0,-100
10323,1,1,642,1453,811
10324,0,0,72,0,-72
10325,0,0,29,0,-29
10326,0,0,75,0,-75
10327,0,0,28,0,-28
10328,1,1,384,1339,955
10329,1,1,58,1694,1636
10330,1,1,136,1258,1122
10331,1,0,49,0,-49
10332,0,0,2,0,-2
10333,0,0,7,0,-7
10334,1,1,158,2089,1931
10335,1,0,140,0,-140
10336,0,0,74,0,-74
10337,0,0,10,0,-10
10338,0,0,61,0,-61
10339,1,0,130,0,-130
10340,1,1,277,2501,2224
10341,1,0,7,0,-7
10342,1,1,507,1296,789
10343,1,1,23,1364,1341
10344,1,0,18,0,-18
10345,0,0,11,0,-11
10346,1,1,587,1506,919
10347,0,0,154,0,-154
10348,0,0,25,0,-25
10349,0,0,35,0,-35
10350,1,0,93,0,-93
10351,0,0,3,0,-3
10352,1,1,36,1201,1165
10353,0,0,56,0,-56
10354,1,1,921,1594,673
10355,0,0,5,0,-5
10356,1,0,222,0,-222
10357,1,1,27,2608,2581
10358,1,1,262,1543,1281
10359,0,0,68,0,-68
10360,0,0,8,0,-8
10361,0,0,84,0,-84
10362,1,0,30,0,-30
10363,1,1,378,2004,1626
10364,0,0,15,0,-15
10365,1,1,40,1472,1432
10366,1,0,14,0,-14
10367,1,1,142,1724,1582
10368,0,0,79,0,-79
10369,1,0,161,0,-161
10370,1,0,64,0,-64
10371,1,0,70,0,-70
10372,0,0,71,0,-71
10373,1,0,102,0,-102
10374,1,1,1173,2229,1056
10375,0,0,8,0,-8
10376,0,0,25,0,-25
10377,0,0,173,0,-173
10378,0,0,29,0,-29
10379,1,0,69,0,-69
10380,0,0,2,0,-2
10381,0,0,4,0,-4
10382,0,0,32,0,-32
10383,1,0,12,0,-12
10384,0,0,34,0,-34
10385,1,0,109,0,-109
10386,1,1,504,2166,1662
10387,0,0,118,0,-118
10388,1,1,1376,1239,-137
10389,1,1,152,1679,1527
10390,1,0,85,0,-85
10391,1,0,33,0,-33
10392,0,0,27,0,-27
10393,1,1,748,1368,620
10394,1,0,66,0,-66
10395,0,0,117,0,-117
10396,1,1,42,1210,1168
10397,0,0,40,0,-40
10398,1,0,19,0,-19
10399,1,1,692,1315,623
10400,1,0,144,0,-144
10401,1,1,521,2438,1917
10402,1,0,52,0,-52
10403,0,0,6,0,-6
10404,0,0,201,0,-201
10405,1,1,201,1579,1378
10406,1,1,340,1272,932
10407,0,0,5,0,-5
10408,1,0,108,0,-108
10409,0,0,4,0,-4
10410,1,1,44,1313,1269
10411,0,0,21,0,-21
10412,1,0,10,0,-10
10413,1,0,44,0,-44
10414,1,0,35,0,-35
10415,1,1,160,1354,1194
10416,1,1,1737,1261,-476
10417,1,1,582,1893,1311
10418,1,1,554,2283,1729
10419,1,1,167,1606,1439
10420,0,0,20,0,-20
10421,0,0,75,0,-75
10422,1,0,3,0,-3
10423,1,1,49,1228,1179
10424,1,0,12,0,-12
10425,1,1,175,1448,1273
10426,1,1,589,1670,1081
10427,1,1,423,1346,923
10428,0,0,28,0,-28
10429,1,1,945,1247,302
10430,1,0,77,0,-77
10431,0,0,37,0,-37
10432,0,0,26,0,-26
10433,0,0,37,0,-37
10434,1,0,130,0,-130
10435,0,0,73,0,-73
10436,1,1,101,1367,1266
10437,0,0,3,0,-3
10438,1,0,1,0,-1
10439,1,1,281,1557,1276
10440,0,0,22,0,-22
10441,0,0,18,0,-18
10442,1,0,56,0,-56
10443,1,0,7,0,-7
10444,1,0,10,0,-10
10445,0,0,9,0,-9
10446,0,0,94,0,-94
10447,1,1,1188,3970,2782
10448,0,0,53,0,-53
10449,1,0,19,0,-19
10450,1,1,134,1528,1394
10451,0,0,2,0,-2
10452,1,1,114,1205,1091
10453,1,0,11,0,-11
10454,0,0,11,0,-11
10455,1,1,254,2168,1914
10456,1,1,319,1326,1007
10457,1,1,1003,1319,316
10458,0,0,39,0,-39
10459,1,1,960,1226,266
10460,1,1,604,1591,987
10461,0,0,0,0,0
10462,1,0,60,0,-60
10463,0,0,45,0,-45
10464,1,0,17,0,-17
10465,0,0,113,0,-113
10466,0,0,12,0,-12
10467,1,0,12,0,-12
10468,0,0,126,0,-126
10469,1,1,288,2859,2571
10470,1,1,586,1538,952
10471,0,0,51,0,-51
10472,1,1,63,2172,2109
10473,0,0,39,0,-39
10474,1,1,712,1457,745
10475,0,0,16,0,-16
10476,1,1,66,2378,2312
10477,1,0,37,0,-37
10478,0,0,20,0,-20
10479,1,0,88,0,-88
10480,1,0,55,0,-55
10481,0,0,6,0,-6
10482,1,1,35,1201,1166
10483,0,0,65,0,-65
10484,0,0,2,0,-2
10485,1,0,14,0,-14
10486,0,0,104,0,-104
10487,1,1,950,1491,541
10488,1,0,24,0,-24
10489,1,0,45,0,-45
10490,1,1,638,1463,825
10491,1,0,0,0,0
10492,0,0,39,0,-39
10493,0,0,105,0,-105
10494,1,0,25,0,-25
10495,1,0,219,0,-219
10496,1,0,111,0,-111
10497,1,0,99,0,-99
10498,0,0,41,0,-41
10499,0,0,1,0,-1
10500,1,1,265,1888,1623
10501,1,1,1642,1595,-47
10502,0,0,36,0,-36
10503,1,0,29,0,-29
10504,1,1,1944,1408,-536
10505,1,0,26,0,-26
10506,1,0,61,0,-61
10507,1,0,8,0,-8
10508,1,1,422,1289,867
10509,1,1,232,1506,1274
10510,1,1,523,1296,773
10511,0,0,22,0,-22
10512,1,1,243,2396,2153
10513,0,0,54,0,-54
10514,0,0,31,0,-31
10515,1,0,77,0,-77
10516,1,1,296,1260,964
10517,1,1,230,2177,1947
10518,0,0,40,0,-40
10519,0,0,74,0,-74
10520,0,0,11,0,-11
10521,1,1,1121,1335,214
10522,0,0,17,0,-17
10523,1,1,1068,1554,486
10524,0,0,63,0,-63
10525,0,0,207,0,-207
10526,1,0,20,0,-20
10527,1,0,143,0,-143
10528,0,0,55,0,-55
10529,1,0,11,0,-11
10530,0,0,11,0,-11
10531,1,0,9,0,-9
10532,1,1,683,1307,624
10533,1,1,172,1314,1142
10534,0,0,59,0,-59
10535,0,0,40,0,-40
10536,0,0,30,0,-30
10537,1,1,395,2333,1938
10538,0,0,70,0,-70
10539,0,0,44,0,-44
10540,0,0,96,0,-96
10541,0,0,24,0,-24
10542,0,0,82,0,-82
10543,0,0,2,0,-2
10544,1,0,105,0,-105
10545,1,0,42,0,-42
10546,1,0,12,0,-12
10547,0,0,19,0,-19
10548,1,0,14,0,-14
10549,0,0,48,0,-48
10550,1,1,1012,1475,463
10551,0,0,148,0,-148
10552,1,1,579,1266,687
10553,1,1,1124,1458,334
10554,1,0,75,0,-75
10555,1,0,0,0,0
10556,1,0,16,0,-16
10557,0,0,59,0,-59
10558,0,0,65,0,-65
10559,0,0,102,0,-102
10560,0,0,38,0,-38
10561,0,0,115,0,-115
10562,1,1,615,1765,1150
10563,0,0,47,0,-47
10564,0,0,104,0,-104
10565,1,1,1171,1451,280
10566,0,0,44,0,-44
10567,1,0,33,0,-33
10568,1,0,14,0,-14
10569,0,0,28,0,-28
10570,1,1,742,1298,556
10571,1,0,33,0,-33
10572,0,0,32,0,-32
10573,1,0,30,0,-30
10574,0,0,36,0,-36
10575,1,1,981,1657,676
10576,1,1,1465,1245,-220
10577,1,1,201,2301,2100
10578,1,1,1055,3183,2128
10579,0,0,79,0,-79
10580,1,1,216,1260,1044
10581,0,0,40,0,-40
10582,0,0,0,0,0
10583,0,0,178,0,-178
10584,1,0,27,0,-27
10585,0,0,25,0,-25
10586,1,1,717,1291,574
10587,1,0,102,0,-102
10588,1,1,980,1329,349
10589,1,1,196,1319,1123
10590,1,0,16,0,-16
10591,1,1,219,2877,2658
10592,1,0,61,0,-61
10593,1,0,85,0,-85
10594,1,0,19,0,-19
10595,1,0,12,0,-12
10596,0,0,87,0,-87
10597,1,1,1864,1259,-605
10598,1,0,73,0,-73
10599,1,0,32,0,-32
10600,1,1,456,1242,786
10601,0,0,145,0,-145
10602,0,0,35,0,-35
10603,1,1,137,1972,1835
10604,1,1,223,1279,1056
10605,1,1,306,1355,1049
10606,1,0,4,0,-4
10607,0,0,23,0,-23
10608,0,0,64,0,-64
10609,1,1,1420,1337,-83
10610,0,0,74,0,-74
10611,1,1,232,1230,998
10612,1,1,423,1594,1171
10613,0,0,0,0,0
10614,1,1,405,1397,992
10615,1,0,7,0,-7
10616,1,1,385,2137,1752
10617,1,1,269,4492,4223
10618,1,1,420,1334,914
10619,0,0,88,0,-88
10620,1,0,77,0,-77
10621,0,0,22,0,-22
10622,1,0,36,0,-36
10623,1,1,901,1396,495
10624,0,0,163,0,-163
10625,0,0,267,0,-267
10626,1,0,92,0,-92
10627,1,1,978,1415,437
10628,1,1,356,1524,1168
10629,1,1,280,1421,1141
10630,1,0,110,0,-110
10631,0,0,205,0,-205
10632,1,1,97,1292,1195
10633,1,0,23,0,-23
10634,0,0,47,0,-47
10635,1,0,21,0,-21
10636,0,0,8,0,-8
10637,0,0,12,0,-12
10638,1,0,74,0,-74
10639,1,1,447,1770,1323
10640,0,0,50,0,-50
10641,1,0,19,0,-19
10642,1,1,650,1591,941
10643,0,0,120,0,-120
10644,1,1,163,1454,1291
10645,1,0,46,0,-46
10646,0,0,56,0,-56
10647,1,0,66,0,-66
10648,1,1,878,1593,715
10649,1,1,653,1251,598
10650,0,0,3,0,-3
10651,1,1,413,1241,828
10652,1,1,275,1629,1354
10653,0,0,29,0,-29
10654,1,0,63,0,-63
10655,1,0,101,0,-101
10656,1,0,162,0,-162
10657,0,0,263,0,-263
10658,0,0,61,0,-61
10659,1,0,63,0,-63
10660,1,1,560,1611,1051
10661,0,0,42,0,-42
10662,0,0,52,0,-52
10663,1,1,78,1217,1139
10664,1,0,20,0,-20
10665,0,0,29,0,-29
10666,1,1,461,1606,1145
10667,0,0,19,0,-19
10668,1,0,45,0,-45
10669,1,1,397,1401,1004
10670,0,0,16,0,-16
10671,1,0,56,0,-56
10672,0,0,37,0,-37
10673,0,0,59,0,-59
10674,0,0,18,0,-18
10675,1,1,273,1308,1035
10676,1,1,732,1378,646
10677,0,0,8,0,-8
10678,1,1,898,1218,320
10679,0,0,24,0,-24
10680,0,0,18,0,-18
10681,1,1,875,1451,576
10682,1,0,283,0,-283
10683,1,0,44,0,-44
10684,1,0,30,0,-30
10685,0,0,11,0,-11
10686,0,0,75,0,-75
10687,0,0,54,0,-54
10688,1,0,48,0,-48
10689,1,1,286,1510,1224
10690,1,0,21,0,-21
10691,0,0,11,0,-11
10692,1,0,30,0,-30
10693,0,0,46,0,-46
10694,1,0,0,0,0
10695,0,0,51,0,-51
10696,0,0,2,0,-2
10697,0,0,2,0,-2
10698,0,0,47,0,-47
10699,0,0,59,0,-59
10700,1,0,24,0,-24
10701,1,0,25,0,-25
10702,1,1,150,1204,1054
10703,0,0,76,0,-76
10704,1,1,406,1238,832
10705,1,1,1727,1310,-417
10706,0,0,47,0,-47
10707,1,0,2,0,-2
10708,1,0,18,0,-18
10709,1,0,33,0,-33
10710,1,0,36,0,-36
10711,1,0,53,0,-53
10712,0,0,36,0,-36
10713,1,1,452,1475,1023
10714,1,1,216,2428,2212
10715,1,0,21,0,-21
10716,0,0,41,0,-41
10717,1,0,47,0,-47
10718,1,1,420,2101,1681
10719,1,1,1101,1977,876
10720,1,0,17,0,-17
10721,1,1,280,1743,1463
10722,1,0,2,0,-2
10723,1,1,376,1224,848
10724,0,0,91,0,-91
10725,1,1,135,1299,1164
10726,1,0,53,0,-53
10727,1,0,68,0,-68
10728,1,1,587,1373,786
10729,1,0,70,0,-70
10730,0,0,25,0,-25
10731,1,1,371,1566,1195
10732,1,0,41,0,-41
10733,1,0,6,0,-6
10734,0,0,39,0,-39
10735,1,0,23,0,-23
10736,1,0,166,0,-166
10737,0,0,155,0,-155
10738,0,0,59,0,-59
10739,1,1,1365,4622,3257
10740,0,0,87,0,-87
10741,0,0,4,0,-4
10742,0,0,156,0,-156
10743,0,0,112,0,-112
10744,1,1,140,1377,1237
10745,0,0,50,0,-50
10746,1,1,66,1229,1163
10747,1,0,57,0,-57
10748,1,1,1206,1333,127
10749,0,0,11,0,-11
10750,1,0,3,0,-3
10751,1,0,34,0,-34
10752,1,0,56,0,-56
10753,1,0,8,0,-8
10754,0,0,13,0,-13
10755,1,0,15,0,-15
10756,1,1,391,2949,2558
10757,1,0,26,0,-26
10758,0,0,0,0,0
10759,1,1,286,1455,1169
10760,1,0,10,0,-10
10761,1,0,3,0,-3
10762,0,0,151,0,-151
10763,0,0,31,0,-31
10764,0,0,129,0,-129
10765,1,1,120,1285,1165
10766,1,1,389,1298,909
10767,1,0,59,0,-59
10768,1,1,35,2285,2250
10769,1,0,0,0,0
10770,1,1,218,2338,2120
10771,0,0,46,0,-46
10772,1,0,199,0,-199
10773,0,0,27,0,-27
10774,1,0,95,0,-95
10775,1,1,656,1252,596
10776,1,0,7,0,-7
10777,0,0,183,0,-183
10778,0,0,2,0,-2
10779,1,0,8,0,-8
10780,0,0,1,0,-1
10781,0,0,62,0,-62
10782,1,0,56,0,-56
10783,0,0,5,0,-5
10784,1,1,572,1487,915
10785,1,0,45,0,-45
10786,1,1,2839,1576,-1263
10787,0,0,4,0,-4
10788,0,0,16,0,-16
10789,0,0,40,0,-40
10790,0,0,178,0,-178
10791,1,0,71,0,-71
10792,0,0,87,0,-87
10793,0,0,41,0,-41
10794,1,1,511,1285,774
10795,1,0,14,0,-14
10796,0,0,115,0,-115
10797,1,1,823,1985,1162
10798,1,1,147,1550,1403
10799,0,0,47,0,-47
10800,1,1,147,1425,1278
10801,1,0,5,0,-5
10802,0,0,9,0,-9
10803,1,1,600,1652,1052
10804,1,1,60,1483,1423
10805,1,1,409,1336,927
10806,1,1,107,1320,1213
10807,0,0,15,0,-15
10808,1,0,7,0,-7
10809,1,1,513,2338,1825
10810,1,1,1565,1326,-239
10811,1,0,9,0,-9
10812,1,0,27,0,-27
10813,1,0,86,0,-86
10814,1,0,43,0,-43
10815,1,1,753,1520,767
10816,0,0,88,0,-88
10817,1,1,360,1238,878
10818,1,0,88,0,-88
10819,0,0,6,0,-6
10820,1,0,39,0,-39
10821,1,0,15,0,-15
10822,1,1,467,1408,941
10823,0,0,174,0,-174
10824,0,0,2,0,-2
10825,1,0,60,0,-60
10826,0,0,39,0,-39
10827,1,0,23,0,-23
10828,1,0,112,0,-112
10829,0,0,18,0,-18
10830,1,1,2053,1254,-799
10831,0,0,43,0,-43
10832,1,1,595,1209,614
10833,1,0,122,0,-122
10834,0,0,12,0,-12
10835,1,1,178,1738,1560
10836,0,0,50,0,-50
10837,0,0,8,0,-8
10838,1,1,551,2762,2211
10839,1,1,312,2915,2603
10840,1,1,1683,2400,717
10841,0,0,71,0,-71
10842,0,0,44,0,-44
10843,0,0,4,0,-4
10844,1,0,3,0,-3
10845,1,1,761,1397,636
10846,0,0,1,0,-1
10847,1,0,45,0,-45
10848,1,0,84,0,-84
10849,0,0,17,0,-17
10850,1,0,38,0,-38
10851,1,1,414,1300,886
10852,1,0,22,0,-22
10853,1,0,91,0,-91
10854,0,0,17,0,-17
10855,0,0,15,0,-15
10856,0,0,12,0,-12
10857,1,0,90,0,-90
10858,1,1,271,1456,1185
10859,1,1,268,1205,937
10860,1,1,817,1218,401
10861,1,0,54,0,-54
10862,0,0,15,0,-15
10863,0,0,44,0,-44
10864,1,0,37,0,-37
10865,0,0,10,0,-10
10866,1,0,40,0,-40
10867,1,1,181,4465,4284
10868,1,1,143,1342,1199
10869,1,0,24,0,-24
10870,0,0,15,0,-15
10871,1,1,698,1247,549
10872,1,1,126,1662,1536
10873,0,0,28,0,-28
10874,1,0,21,0,-21
10875,1,1,624,1370,746
10876,0,0,27,0,-27
10877,1,0,27,0,-27
10878,1,0,27,0,-27
10879,1,1,142,1229,1087
10880,1,1,407,1237,830
10881,1,1,314,1317,1003
10882,1,0,10,0,-10
10883,0,0,9,0,-9
10884,1,0,10,0,-10
10885,1,1,390,1620,1230
10886,0,0,48,0,-48
10887,1,0,72,0,-72
10888,0,0,13,0,-13
10889,1,0,28,0,-28
10890,1,0,172,0,-172
10891,0,0,9,0,-9
10892,1,1,196,1735,1539
10893,1,1,474,1297,823
10894,1,0,27,0,-27
10895,0,0,19,0,-19
10896,0,0,25,0,-25
10897,1,1,66,2599,2533
10898,0,0,2,0,-2
10899,0,0,75,0,-75
10900,1,0,38,0,-38
10901,0,0,19,0,-19
10902,0,0,119,0,-119
10903,1,0,7,0,-7
10904,0,0,26,0,-26
10905,0,0,7,0,-7
10906,1,0,1,0,-1
10907,0,0,50,0,-50
10908,0,0,17,0,-17
10909,0,0,34,0,-34
10910,0,0,1,0,-1
10911,0,0,157,0,-157
10912,1,1,184,2011,1827
10913,1,0,14,0,-14
10914,1,0,39,0,-39
10915,0,0,122,0,-122
10916,1,0,14,0,-14
10917,0,0,194,0,-194
10918,1,0,36,0,-36
10919,0,0,19,0,-19
10920,0,0,72,0,-72
10921,1,1,85,1371,1286
10922,0,0,78,0,-78
10923,0,0,43,0,-43
10924,1,0,0,0,0
10925,1,1,594,2341,1747
10926,1,0,21,0,-21
10927,0,0,24,0,-24
10928,0,0,6,0,-6
10929,1,0,49,0,-49
10930,1,0,60,0,-60
10931,1,0,20,0,-20
10932,1,1,425,1205,780
10933,1,0,47,0,-47
10934,1,1,887,2137,1250
10935,0,0,1,0,-1
10936,0,0,195,0,-195
10937,1,1,35,1207,1172
10938,0,0,14,0,-14
10939,0,0,38,0,-38
10940,1,1,270,1240,970
10941,0,0,140,0,-140
10942,1,1,1277,1251,-26
10943,0,0,29,0,-29
10944,1,1,743,1234,491
10945,1,1,100,1212,1112
10946,1,0,2,0,-2
10947,1,1,855,1887,1032
10948,1,1,1083,1211,128
10949,1,1,98,1253,1155
10950,0,0,48,0,-48
10951,0,0,16,0,-16
10952,0,0,13,0,-13
10953,0,0,22,0,-22
10954,1,0,21,0,-21
10955,0,0,7,0,-7
10956,0,0,19,0,-19
10957,0,0,9,0,-9
10958,1,0,10,0,-10
10959,1,0,40,0,-40
10960,1,1,275,1746,1471
10961,1,0,44,0,-44
10962,0,0,30,0,-30
10963,1,0,8,0,-8
10964,0,0,48,0,-48
10965,1,0,105,0,-105
10966,1,1,88,1237,1149
10967,1,1,557,1254,697
10968,0,0,53,0,-53
10969,0,0,24,0,-24
10970,1,1,394,1289,895
10971,0,0,25,0,-25
10972,0,0,68,0,-68
10973,1,0,32,0,-32
10974,1,1,37,1939,1902
10975,0,0,19,0,-19
10976,1,0,10,0,-10
10977,1,0,53,0,-53
10978,1,1,499,1465,966
10979,0,0,59,0,-59
10980,1,0,66,0,-66
10981,1,0,47,0,-47
10982,1,1,207,1380,1173
10983,1,1,107,1257,1150
10984,0,0,33,0,-33
10985,0,0,49,0,-49
10986,1,1,1242,2007,765
10987,1,0,89,0,-89
10988,0,0,13,0,-13
10989,0,0,69,0,-69
10990,1,0,4,0,-4
10991,0,0,20,0,-20
10992,0,0,3,0,-3
10993,0,0,91,0,-91
10994,1,0,82,0,-82
10995,1,1,447,1411,964
10996,1,1,183,1878,1695
10997,0,0,14,0,-14
10998,0,0,8,0,-8
10999,0,0,37,0,-37
11000,0,0,18,0,-18
11001,0,0,231,0,-231
11002,1,1,313,4992,4679
11003,1,0,29,0,-29
11004,0,0,82,0,-82
11005,0,0,23,0,-23
11006,0,0,151,0,-151
11007,1,0,15,0,-15
11008,0,0,4,0,-4
11009,1,0,16,0,-16
11010,1,0,43,0,-43
11011,0,0,5,0,-5
11012,1,0,39,0,-39
11013,1,1,358,1822,1464
11014,1,0,51,0,-51
11015,1,0,105,0,-105
11016,1,0,73,0,-73
11017,1,0,18,0,-18
11018,1,1,541,1298,757
11019,1,0,45,0,-45
11020,1,0,12,0,-12
11021,1,0,155,0,-155
11022,1,1,502,1678,1176
11023,0,0,74,0,-74
11024,0,0,9,0,-9
11025,1,1,1271,1597,326
11026,0,0,217,0,-217
11027,0,0,41,0,-41
11028,0,0,37,0,-37
11029,0,0,13,0,-13
11030,0,0,96,0,-96
11031,1,1,579,1344,765
11032,1,1,446,1279,833
11033,0,0,65,0,-65
11034,0,0,2,0,-2
11035,1,0,20,0,-20
11036,1,0,21,0,-21
11037,0,0,6,0,-6
11038,1,1,447,1229,782
11039,1,1,283,3431,3148
11040,1,0,13,0,-13
11041,0,0,106,0,-106
11042,0,0,111,0,-111
11043,1,0,137,0,-137
11044,0,0,73,0,-73
11045,1,1,667,3004,2337
11046,0,0,28,0,-28
11047,0,0,21,0,-21
11048,1,1,664,1406,742
11049,1,1,265,1260,995
11050,1,1,383,1672,1289
11051,1,0,79,0,-79
11052,1,0,72,0,-72
11053,0,0,25,0,-25
11054,0,0,1,0,-1
11055,1,0,21,0,-21
11056,1,1,155,1549,1394
11057,0,0,80,0,-80
11058,1,0,11,0,-11
11059,1,0,95,0,-95
11060,0,0,19,0,-19
11061,0,0,60,0,-60
11062,1,1,370,1511,1141
11063,1,1,590,1482,892
11064,1,0,27,0,-27
11065,0,0,9,0,-9
11066,1,1,14,1570,1556
11067,0,0,22,0,-22
11068,1,0,376,0,-376
11069,1,1,271,1389,1118
11070,0,0,28,0,-28
11071,0,0,19,0,-19
11072,1,1,433,1237,804
11073,0,0,101,0,-101
11074,1,1,194,1457,1263
11075,1,1,201,1240,1039
11076,0,0,46,0,-46
11077,0,0,69,0,-69
11078,1,0,53,0,-53
11079,1,0,21,0,-21
11080,1,0,43,0,-43
11081,1,0,41,0,-41
11082,1,1,312,1236,924
11083,1,1,464,1305,841
11084,1,1,174,1575,1401
11085,1,0,49,0,-49
11086,1,0,3,0,-3
11087,1,0,4,0,-4
11088,1,0,67,0,-67
11089,0,0,23,0,-23
11090,0,0,56,0,-56
11091,0,0,57,0,-57
11092,0,0,10,0,-10
11093,1,1,397,1305,908
11094,0,0,172,0,-172
11095,1,1,665,1496,831
11096,1,1,548,3248,2700
11097,0,0,59,0,-59
11098,0,0,152,0,-152
11099,1,0,12,0,-12
11100,1,1,1006,2815,1809
11101,0,0,151,0,-151
11102,0,0,18,0,-18
11103,1,1,578,1496,918
11104,0,0,33,0,-33
11105,0,0,30,0,-30
11106,1,1,288,1705,1417
11107,1,1,64,1265,1201
11108,1,0,40,0,-40
11109,1,1,703,1273,570
11110,0,0,83,0,-83
11111,1,1,1375,1223,-152
11112,0,0,41,0,-41
11113,1,0,9,0,-9
11114,1,0,20,0,-20
11115,1,0,14,0,-14
11116,1,0,49,0,-49
11117,1,0,12,0,-12
11118,1,0,30,0,-30
11119,1,1,103,3396,3293
11120,0,0,48,0,-48
11121,1,1,346,1367,1021
11122,1,0,7,0,-7
11123,1,0,38,0,-38
11124,0,0,14,0,-14
11125,0,0,62,0,-62
11126,1,1,1752,1262,-490
11127,1,0,2,0,-2
11128,1,1,100,1288,1188
11129,1,1,500,1211,711
11130,1,0,63,0,-63
11131,0,0,46,0,-46
11132,0,0,13,0,-13
11133,0,0,26,0,-26
11134,1,1,663,1270,607
11135,1,1,79,1704,1625
11136,1,1,538,1902,1364
11137,0,0,107,0,-107
11138,1,1,1007,1393,386
11139,1,1,384,1246,862
11140,1,0,152,0,-152
11141,1,1,528,1304,776
11142,1,0,57,0,-57
11143,0,0,113,0,-113
11144,0,0,7,0,-7
11145,0,0,17,0,-17
11146,1,0,329,0,-329
11147,1,0,119,0,-119
11148,1,0,36,0,-36
11149,1,0,5,0,-5
11150,0,0,7,0,-7
11151,0,0,48,0,-48
11152,1,1,545,1293,748
11153,1,1,202,1272,1070
11154,1,0,1,0,-1
11155,0,0,89,0,-89
11156,0,0,26,0,-26
11157,0,0,15,0,-15
11158,0,0,54,0,-54
11159,0,0,20,0,-20
11160,1,1,214,1880,1666
11161,1,0,23,0,-23
11162,1,1,76,1532,1456
11163,1,1,1812,1243,-569
11164,1,1,1346,1359,13
11165,0,0,2,0,-2
11166,1,1,85,1230,1145
11167,1,0,0,0,0
11168,1,0,27,0,-27
11169,0,0,20,0,-20
11170,1,0,23,0,-23
11171,1,1,42,2616,2574
11172,1,0,39,0,-39
11173,0,0,84,0,-84
11174,0,0,35,0,-35
11175,1,1,85,1412,1327
11176,0,0,53,0,-53
11177,1,0,40,0,-40
11178,1,1,366,1266,900
11179,1,1,198,1200,1002
11180,1,1,175,1467,1292
11181,0,0,11,0,-11
11182,0,0,95,0,-95
11183,1,1,818,1521,703
11184,0,0,41,0,-41
11185,1,1,467,1765,1298
11186,0,0,8,0,-8
11187,0,0,79,0,-79
11188,1,1,82,1584,1502
11189,0,0,0,0,0
11190,0,0,51,0,-51
11191,1,0,44,0,-44
11192,1,1,350,1485,1135
11193,0,0,97,0,-97
11194,1,1,280,2926,2646
11195,1,1,92,1290,1198
11196,1,1,386,1493,1107
11197,1,1,53,1421,1368
11198,1,1,1308,1811,503
11199,0,0,7,0,-7
11200,1,0,69,0,-69
11201,0,0,35,0,-35
11202,0,0,20,0,-20
11203,0,0,41,0,-41
11204,0,0,31,0,-31
11205,0,0,87,0,-87
11206,0,0,46,0,-46
11207,1,0,13,0,-13
11208,1,0,42,0,-42
11209,1,0,25,0,-25
11210,0,0,117,0,-117
11211,0,0,7,0,-7
11212,1,1,179,1657,1478
11213,1,1,240,1763,1523
11214,1,1,93,1908,1815
11215,1,0,14,0,-14
11216,1,0,69,0,-69
11217,1,1,161,1252,1091
11218,1,0,23,0,-23
11219,0,0,144,0,-144
11220,1,1,97,1460,1363
11221,0,0,46,0,-46
11222,1,1,125,1348,1223
11223,1,0,25,0,-25
11224,0,0,8,0,-8
11225,0,0,137,0,-137
11226,0,0,2,0,-2
11227,1,1,728,1308,580
11228,1,1,253,1323,1070
11229,0,0,121,0,-121
11230,1,1,185,1481,1296
11231,0,0,11,0,-11
11232,1,0,0,0,0
11233,1,0,235,0,-235
11234,1,0,99,0,-99
11235,0,0,3,0,-3
11236,0,0,23,0,-23
11237,1,0,36,0,-36
11238,1,0,142,0,-142
11239,1,1,1016,1223,207
11240,1,1,1763,1425,-338
11241,1,1,1314,2174,860
11242,1,0,7,0,-7
11243,1,1,419,1219,800
11244,0,0,147,0,-147
11245,1,1,543,1497,954
11246,0,0,16,0,-16
11247,0,0,26,0,-26
11248,1,1,1802,1639,-163
11249,0,0,27,0,-27
11250,1,0,33,0,-33
11251,1,0,19,0,-19
11252,1,0,14,0,-14
11253,0,0,91,0,-91
11254,1,0,7,0,-7
11255,1,0,6,0,-6
11256,0,0,18,0,-18
11257,0,0,9,0,-9
11258,1,1,471,1303,832
11259,1,1,797,1892,1095
11260,1,1,774,1220,446
11261,0,0,5,0,-5
11262,0,0,0,0,0
11263,1,1,547,1634,1087
11264,1,1,233,1668,1435
11265,1,1,408,1244,836
11266,1,1,1151,1520,369
11267,1,0,27,0,-27
11268,1,1,61,2399,2338
11269,0,0,41,0,-41
11270,0,0,12,0,-12
11271,1,0,28,0,-28
11272,0,0,7,0,-7
11273,1,0,45,0,-45
11274,1,0,57,0,-57
11275,1,0,15,0,-15
11276,0,0,64,0,-64
11277,0,0,19,0,-19
11278,0,0,106,0,-106
11279,1,1,57,2489,2432
11280,1,1,1071,1387,316
11281,0,0,46,0,-46
11282,1,1,345,1374,1029
11283,0,0,11,0,-11
11284,0,0,92,0,-92
11285,1,0,43,0,-43
11286,1,0,21,0,-21
11287,0,0,14,0,-14
11288,0,0,6,0,-6
11289,0,0,211,0,-211
11290,0,0,42,0,-42
11291,0,0,85,0,-85
11292,1,1,777,1609,832
11293,1,1,306,2993,2687
11294,1,0,40,0,-40
11295,1,0,30,0,-30
11296,0,0,18,0,-18
11297,1,0,81,0,-81
11298,0,0,8,0,-8
11299,0,0,40,0,-40
11300,0,0,71,0,-71
11301,0,0,102,0,-102
11302,0,0,157,0,-157
11303,1,1,297,1324,1027
11304,1,0,47,0,-47
11305,1,1,441,1213,772
11306,1,0,4,0,-4
11307,0,0,85,0,-85
11308,1,0,6,0,-6
11309,0,0,28,0,-28
11310,1,1,175,1260,1085
11311,0,0,0,0,0
11312,0,0,6,0,-6
11313,1,1,182,1627,1445
11314,1,1,241,3900,3659
11315,0,0,5,0,-5
11316,1,0,6,0,-6
11317,0,0,81,0,-81
11318,0,0,11,0,-11
11319,1,0,2,0,-2
11320,1,0,237,0,-237
11321,1,0,49,0,-49
11322,0,0,30,0,-30
11323,1,0,45,0,-45
11324,0,0,46,0,-46
11325,1,1,64,1762,1698
11326,1,0,67,0,-67
11327,0,0,15,0,-15
11328,0,0,16,0,-16
11329,1,1,200,1617,1417
11330,0,0,5,0,-5
11331,1,0,7,0,-7
11332,1,0,79,0,-79
11333,0,0,22,0,-22
11334,1,0,9,0,-9
11335,0,0,5,0,-5
11336,1,1,143,2057,1914
11337,1,1,1273,1952,679
11338,0,0,27,0,-27
11339,1,0,268,0,-268
11340,0,0,12,0,-12
11341,0,0,59,0,-59
11342,1,1,1231,1278,47
11343,1,0,35,0,-35
11344,1,1,1073,1741,668
11345,1,0,5,0,-5
11346,0,0,0,0,0
11347,1,0,25,0,-25
11348,0,0,55,0,-55
11349,1,1,240,1978,1738
11350,1,0,34,0,-34
11351,1,1,368,1503,1135
11352,1,1,664,1979,1315
11353,1,1,51,2289,2238
11354,1,0,3,0,-3
11355,1,1,190,1230,1040
11356,1,1,144,1517,1373
11357,1,1,593,1203,610
11358,1,1,539,2588,2049
11359,1,1,231,1494,1263
11360,1,1,263,1478,1215
11361,1,1,1470,4183,2713
11362,0,0,60,0,-60
11363,1,0,12,0,-12
11364,0,0,5,0,-5
11365,1,0,24,0,-24
11366,1,1,580,1758,1178
11367,1,0,102,0,-102
11368,1,1,808,1806,998
11369,1,1,752,1581,829
11370,1,1,328,3774,3446
11371,1,0,46,0,-46
11372,0,0,0,0,0
11373,1,1,13,1217,1204
11374,1,0,3,0,-3
11375,0,0,7,0,-7
11376,1,1,239,2177,1938
11377,0,0,54,0,-54
11378,1,0,78,0,-78
11379,1,1,260,1218,958
11380,1,1,585,1223,638
11381,1,1,540,1487,947
11382,1,0,34,0,-34
11383,1,0,14,0,-14
11384,0,0,41,0,-41
11385,0,0,41,0,-41
11386,1,0,64,0,-64
11387,0,0,25,0,-25
11388,0,0,4,0,-4
11389,1,1,557,1383,826
11390,0,0,51,0,-51
11391,0,0,92,0,-92
11392,0,0,58,0,-58
11393,1,1,238,1233,995
11394,0,0,58,0,-58
11395,1,0,110,0,-110
11396,1,1,406,1433,1027
11397,1,1,320,1610,1290
11398,1,1,503,1893,1390
11399,1,1,117,1547,1430
11400,0,0,54,0,-54
11401,1,1,126,1851,1725
11402,0,0,53,0,-53
11403,1,0,60,0,-60
11404,0,0,102,0,-102
11405,0,0,68,0,-68
11406,1,0,52,0,-52
11407,0,0,37,0,-37
11408,1,0,47,0,-47
11409,1,1,1155,1222,67
11410,1,1,79,2536,2457
11411,1,1,159,1211,1052
11412,1,1,489,2429,1940
11413,1,1,1625,1961,336
11414,1,0,1,0,-1
11415,1,0,162,0,-162
11416,1,1,14,2948,2934
11417,1,0,43,0,-43
11418,0,0,7,0,-7
11419,1,1,294,1310,1016
11420,1,1,441,1281,840
11421,0,0,148,0,-148
11422,1,0,1,0,-1
11423,1,1,1740,4293,2553
11424,0,0,19,0,-19
11425,1,0,45,0,-45
11426,1,1,146,1217,1071
11427,0,0,12,0,-12
11428,1,0,11,0,-11
11429,1,1,1379,1451,72
11430,1,1,232,1422,1190
11431,1,0,85,0,-85
11432,1,1,158,1222,1064
11433,1,1,858,1448,590
11434,0,0,52,0,-52
11435,1,1,535,1246,711
11436,1,1,893,1417,524
11437,1,1,199,1622,1423
11438,1,1,440,2515,2075
11439,0,0,22,0,-22
11440,0,0,44,0,-44
11441,1,1,112,1481,1369
11442,1,0,79,0,-79
11443,1,0,11,0,-11
11444,1,0,6,0,-6
11445,1,1,662,1386,724
11446,0,0,5,0,-5
11447,1,1,523,1372,849
11448,1,1,526,1228,702
11449,1,0,6,0,-6
11450,1,1,258,1313,1055
11451,1,1,1144,1376,232
11452,1,0,44,0,-44
11453,0,0,51,0,-51
11454,0,0,14,0,-14
11455,1,1,266,1390,1124
11456,1,1,1656,1587,-69
11457,1,0,44,0,-44
11458,0,0,75,0,-75
11459,1,1,1289,1550,261
11460,0,0,93,0,-93
11461,1,1,470,1234,764
11462,0,0,6,0,-6
11463,1,0,75,0,-75
11464,0,0,6,0,-6
11465,1,0,4,0,-4
11466,0,0,54,0,-54
11467,1,1,808,3452,2644
11468,1,1,270,1562,1292
11469,1,0,18,0,-18
11470,0,0,32,0,-32
11471,0,0,54,0,-54
11472,0,0,69,0,-69
11473,1,1,88,2749,2661
11474,1,1,253,1856,1603
11475,0,0,43,0,-43
11476,1,0,14,0,-14
11477,1,1,217,1247,1030
11478,0,0,20,0,-20
11479,0,0,0,0,0
11480,1,0,4,0,-4
11481,1,1,264,1244,980
11482,0,0,28,0,-28
11483,1,1,143,1220,1077
11484,1,1,899,1289,390
11485,1,0,15,0,-15
11486,0,0,93,0,-93
11487,0,0,11,0,-11
11488,1,1,447,1298,851
11489,0,0,45,0,-45
11490,1,1,1184,1305,121
11491,1,1,174,1919,1745
11492,1,1,110,2891,2781
11493,0,0,49,0,-49
11494,0,0,97,0,-97
11495,1,1,103,2003,1900
11496,0,0,15,0,-15
11497,1,1,414,2363,1949
11498,0,0,28,0,-28
11499,1,1,778,1963,1185
11500,1,1,207,2432,2225
11501,1,0,18,0,-18
11502,1,1,230,2711,2481
11503,0,0,17,0,-17
11504,1,0,4,0,-4
11505,0,0,28,0,-28
11506,1,1,827,1735,908
11507,0,0,0,0,0
11508,1,0,25,0,-25
11509,1,0,96,0,-96
11510,0,0,73,0,-73
11511,1,0,30,0,-30
11512,1,1,624,2241,1617
11513,1,0,7,0,-7
11514,1,1,168,1270,1102
11515,1,0,2,0,-2
11516,0,0,42,0,-42
11517,1,1,507,1202,695
11518,0,0,48,0,-48
11519,0,0,47,0,-47
11520,1,1,454,1850,1396
11521,0,0,26,0,-26
11522,1,1,643,1240,597
11523,1,0,82,0,-82
11524,1,1,132,1212,1080
11525,0,0,16,0,-16
11526,0,0,36,0,-36
11527,1,1,637,1420,783
11528,1,1,523,1251,728
11529,0,0,3,0,-3
11530,1,0,196,0,-196
11531,0,0,79,0,-79
11532,1,1,203,4348,4145
11533,0,0,46,0,-46
11534,1,1,459,2449,1990
11535,1,0,33,0,-33
11536,0,0,11,0,-11
11537,0,0,4,0,-4
11538,1,1,661,1249,588
11539,0,0,49,0,-49
11540,0,0,114,0,-114
11541,0,0,28,0,-28
11542,1,0,85,0,-85
11543,0,0,200,0,-200
11544,1,1,608,1483,875
11545,1,1,351,1607,1256
11546,1,1,157,1500,1343
11547,1,1,686,1352,666
11548,0,0,54,0,-54
11549,0,0,81,0,-81
11550,0,0,6,0,-6
11551,1,1,91,1369,1278
11552,1,0,1,0,-1
11553,0,0,40,0,-40
11554,0,0,37,0,-37
11555,0,0,57,0,-57
11556,1,0,3,0,-3
11557,0,0,7,0,-7
11558,1,0,5,0,-5
11559,0,0,94,0,-94
11560,0,0,3,0,-3
11561,1,1,150,1617,1467
11562,0,0,81,0,-81
11563,0,0,31,0,-31
11564,1,1,971,1742,771
11565,0,0,42,0,-42
11566,0,0,18,0,-18
11567,1,0,10,0,-10
11568,0,0,106,0,-106
11569,0,0,117,0,-117
11570,1,0,81,0,-81
11571,1,1,1215,1626,411
11572,0,0,34,0,-34
11573,1,1,1641,1685,44
11574,0,0,102,0,-102
11575,1,0,39,0,-39
11576,1,0,32,0,-32
11577,0,0,47,0,-47
11578,1,1,543,1687,1144
11579,1,0,112,0,-112
11580,1,0,35,0,-35
11581,1,1,29,1783,1754
11582,0,0,0,0,0
11583,0,0,63,0,-63
11584,0,0,44,0,-44
11585,0,0,85,0,-85
11586,0,0,217,0,-217
11587,1,0,39,0,-39
11588,0,0,1,0,-1
11589,1,0,35,0,-35
11590,1,1,128,1355,1227
11591,0,0,15,0,-15
11592,1,0,18,0,-18
11593,1,0,11,0,-11
11594,1,1,1593,1311,-282
11595,1,1,210,1644,1434
11596,1,0,36,0,-36
11597,0,0,22,0,-22
11598,1,0,155,0,-155
11599,1,0,23,0,-23
11600,0,0,19,0,-19
11601,0,0,40,0,-40
11602,1,0,82,0,-82
11603,0,0,39,0,-39
11604,0,0,4,0,-4
11605,1,1,272,1635,1363
11606,1,1,410,1216,806
11607,1,0,48,0,-48
11608,1,1,185,1259,1074
11609,1,0,163,0,-163
11610,1,0,26,0,-26
11611,0,0,15,0,-15
11612,1,1,608,1222,614
11613,0,0,57,0,-57
11614,0,0,15,0,-15
11615,0,0,47,0,-47
11616,1,0,1,0,-1
11617,1,1,773,1427,654
11618,1,0,3,0,-3
11619,1,0,20,0,-20
11620,1,1,511,1441,930
11621,1,0,16,0,-16
11622,1,1,271,1726,1455
11623,0,0,97,0,-97
11624,1,0,8,0,-8
11625,1,0,22,0,-22
11626,1,1,920,2097,1177
11627,0,0,48,0,-48
11628,1,1,250,1468,1218
11629,0,0,33,0,-33
11630,0,0,91,0,-91
11631,0,0,5,0,-5
11632,1,1,1595,1463,-132
11633,1,1,142,2039,1897
11634,0,0,14,0,-14
11635,1,1,178,1347,1169
11636,1,1,452,1213,761
11637,0,0,7,0,-7
11638,0,0,95,0,-95
11639,0,0,72,0,-72
11640,1,1,102,1379,1277
11641,0,0,142,0,-142
11642,1,1,815,2210,1395
11643,1,1,924,1250,326
11644,0,0,1,0,-1
11645,0,0,17,0,-17
11646,1,0,62,0,-62
11647,0,0,11,0,-11
11648,0,0,39,0,-39
11649,0,0,64,0,-64
11650,0,0,128,0,-128
11651,1,0,73,0,-73
11652,0,0,14,0,-14
11653,1,0,34,0,-34
11654,1,1,851,1247,396
11655,0,0,2,0,-2
11656,0,0,0,0,0
11657,1,0,255,0,-255
11658,0,0,48,0,-48
11659,1,0,24,0,-24
11660,0,0,11,0,-11
11661,1,0,37,0,-37
11662,1,0,213,0,-213
11663,0,0,0,0,0
11664,1,0,10,0,-10
11665,1,0,122,0,-122
11666,0,0,16,0,-16
11667,1,0,17,0,-17
11668,1,0,52,0,-52
11669,1,1,194,1649,1455
11670,0,0,16,0,-16
11671,1,1,902,1957,1055
11672,1,0,180,0,-180
11673,0,0,12,0,-12
11674,1,0,0,0,0
11675,1,1,311,1706,1395
11676,1,0,60,0,-60
11677,0,0,178,0,-178
11678,1,0,16,0,-16
11679,1,1,177,1368,1191
11680,0,0,77,0,-77
11681,1,0,4,0,-4
11682,1,1,531,1305,774
11683,0,0,10,0,-10
11684,0,0,39,0,-39
11685,1,0,50,0,-50
11686,0,0,4,0,-4
11687,0,0,71,0,-71
11688,0,0,105,0,-105
11689,1,1,314,1210,896
11690,0,0,61,0,-61
11691,1,0,23,0,-23
11692,1,0,68,0,-68
11693,1,1,253,2209,1956
11694,1,1,239,1201,962
11695,0,0,192,0,-192
11696,0,0,9,0,-9
11697,1,0,27,0,-27
11698,0,0,87,0,-87
11699,1,0,38,0,-38
11700,0,0,2,0,-2
11701,0,0,48,0,-48
11702,1,1,277,1308,1031
11703,1,1,1221,1354,133
11704,1,0,5,0,-5
11705,1,1,385,1226,841
11706,1,0,76,0,-76
11707,1,1,567,2051,1484
11708,1,1,443,1685,1242
11709,0,0,144,0,-144
11710,1,1,124,1239,1115
11711,1,1,1716,1355,-361
11712,1,0,23,0,-23
11713,0,0,98,0,-98
11714,0,0,108,0,-108
11715,0,0,65,0,-65
11716,0,0,7,0,-7
11717,0,0,14,0,-14
11718,1,0,16,0,-16
11719,0,0,88,0,-88
11720,0,0,118,0,-118
11721,1,0,9,0,-9
11722,1,0,42,0,-42
11723,0,0,61,0,-61
11724,0,0,116,0,-116
11725,1,1,264,1518,1254
11726,0,0,49,0,-49
11727,0,0,132,0,-132
11728,1,0,77,0,-77
11729,1,0,143,0,-143
11730,1,0,24,0,-24
11731,1,0,56,0,-56
11732,1,0,27,0,-27
11733,1,1,576,1669,1093
11734,1,1,333,1838,1505
11735,1,1,412,1278,866
11736,1,1,269,1495,1226
11737,0,0,24,0,-24
11738,1,0,60,0,-60
11739,1,0,52,0,-52
11740,1,0,1,0,-1
11741,0,0,6,0,-6
11742,1,1,69,1662,1593
11743,0,0,26,0,-26
11744,0,0,3,0,-3
11745,1,1,160,1499,1339
11746,0,0,4,0,-4
11747,1,1,234,1869,1635
11748,1,1,488,2277,1789
11749,0,0,18,0,-18
11750,1,1,187,1243,1056
11751,1,1,267,1313,1046
11752,1,0,43,0,-43
11753,1,0,20,0,-20
11754,1,1,390,1205,815
11755,0,0,60,0,-60
11756,1,0,145,0,-145
11757,1,0,167,0,-167
11758,0,0,23,0,-23
11759,0,0,10,0,-10
11760,0,0,59,0,-59
11761,0,0,21,0,-21
11762,1,1,223,1491,1268
11763,1,1,130,1204,1074
11764,1,0,19,0,-19
11765,1,0,107,0,-107
11766,0,0,4,0,-4
11767,1,0,47,0,-47
11768,1,1,616,1892,1276
11769,1,1,189,1641,1452
11770,0,0,20,0,-20
11771,1,0,98,0,-98
11772,1,0,42,0,-42
11773,1,0,4,0,-4
11774,0,0,92,0,-92
11775,1,0,24,0,-24
11776,0,0,80,0,-80
11777,1,0,7,0,-7
11778,0,0,2,0,-2
11779,1,0,30,0,-30
11780,1,1,599,1267,668
11781,0,0,18,0,-18
11782,1,0,58,0,-58
11783,1,1,108,1438,1330
11784,1,0,1,0,-1
11785,0,0,103,0,-103
11786,1,1,254,1969,1715
11787,1,0,28,0,-28
11788,1,1,124,1328,1204
11789,1,1,293,1782,1489
11790,0,0,14,0,-14
11791,1,0,34,0,-34
11792,1,1,93,1207,1114
11793,1,1,231,2213,1982
11794,0,0,27,0,-27
11795,1,1,193,2412,2219
11796,0,0,95,0,-95
11797,0,0,11,0,-11
11798,1,1,49,1487,1438
11799,1,1,292,1231,939
11800,0,0,25,0,-25
11801,1,1,205,1209,1004
11802,1,0,75,0,-75
11803,0,0,2,0,-2
11804,1,0,75,0,-75
11805,1,1,447,1281,834
11806,1,1,760,1273,513
11807,0,0,4,0,-4
11808,1,1,331,1943,1612
11809,1,1,432,1694,1262
11810,0,0,3,0,-3
11811,0,0,25,0,-25
11812,0,0,93,0,-93
11813,1,0,29,0,-29
11814,1,0,9,0,-9
11815,0,0,7,0,-7
11816,0,0,5,0,-5
11817,1,1,882,1555,673
11818,1,1,202,1324,1122
11819,0,0,111,0,-111
11820,0,0,132,0,-132
11821,1,1,185,1943,1758
11822,1,1,199,2292,2093
11823,1,0,190,0,-190
11824,1,0,37,0,-37
11825,0,0,49,0,-49
11826,1,1,1397,1897,500
11827,1,0,8,0,-8
11828,0,0,148,0,-148
11829,1,1,55,3463,3408
11830,0,0,9,0,-9
11831,1,0,46,0,-46
11832,1,0,11,0,-11
11833,0,0,117,0,-117
11834,0,0,33,0,-33
11835,1,0,81,0,-81
11836,1,1,412,1275,863
11837,1,1,237,1282,1045
11838,1,1,553,1296,743
11839,0,0,14,0,-14
11840,1,0,54,0,-54
11841,1,0,11,0,-11
11842,0,0,78,0,-78
11843,1,0,44,0,-44
11844,1,0,67,0,-67
11845,0,0,3,0,-3
11846,0,0,32,0,-32
11847,1,0,46,0,-46
11848,1,0,20,0,-20
11849,1,1,758,1466,708
11850,1,1,331,1328,997
11851,1,1,1282,1483,201
11852,0,0,7,0,-7
11853,1,1,462,1961,1499
11854,1,0,147,0,-147
11855,1,1,1412,1571,159
11856,1,1,621,1400,779
11857,1,0,125,0,-125
11858,1,1,181,1237,1056
11859,1,0,103,0,-103
11860,1,1,490,1215,725
11861,0,0,100,0,-100
11862,1,1,962,1786,824
11863,0,0,69,0,-69
11864,1,1,177,1202,1025
11865,1,0,6,0,-6
11866,0,0,87,0,-87
11867,1,0,92,0,-92
11868,1,1,262,1703,1441
11869,0,0,53,0,-53
11870,1,0,102,0,-102
11871,1,1,351,1257,906
11872,1,0,0,0,0
11873,1,1,1096,1627,531
11874,1,1,199,1421,1222
11875,0,0,90,0,-90
11876,0,0,67,0,-67
11877,0,0,43,0,-43
11878,1,0,27,0,-27
11879,0,0,27,0,-27
11880,0,0,8,0,-8
11881,1,0,114,0,-114
11882,1,0,20,0,-20
11883,1,0,111,0,-111
11884,0,0,65,0,-65
11885,0,0,33,0,-33
11886,0,0,20,0,-20
11887,0,0,269,0,-269
11888,0,0,38,0,-38
11889,0,0,207,0,-207
11890,1,0,43,0,-43
11891,1,0,56,0,-56
11892,1,0,0,0,0
11893,1,0,20,0,-20
11894,0,0,64,0,-64
11895,1,0,23,0,-23
11896,0,0,61,0,-61
11897,0,0,12,0,-12
11898,0,0,250,0,-250
11899,0,0,114,0,-114
11900,1,0,98,0,-98
11901,0,0,183,0,-183
11902,1,1,485,1412,927
11903,1,1,23,1587,1564
11904,0,0,21,0,-21
11905,0,0,30,0,-30
11906,1,1,1209,1277,68
11907,1,1,805,2216,1411
11908,1,1,224,1463,1239
11909,1,1,148,1527,1379
11910,0,0,15,0,-15
11911,1,1,257,1388,1131
11912,1,1,191,1256,1065
11913,1,0,66,0,-66
11914,1,1,742,1300,558
11915,0,0,82,0,-82
11916,1,0,125,0,-125
11917,1,1,244,1359,1115
11918,1,0,26,0,-26
11919,1,1,893,1347,454
11920,1,1,173,2880,2707
11921,0,0,16,0,-16
11922,0,0,36,0,-36
11923,0,0,17,0,-17
11924,1,1,301,1316,1015
11925,1,1,112,1271,1159
11926,1,1,147,1292,1145
11927,0,0,17,0,-17
11928,0,0,87,0,-87
11929,1,0,124,0,-124
11930,0,0,8,0,-8
11931,1,1,208,1439,1231
11932,0,0,51,0,-51
11933,1,1,33,1254,1221
11934,1,0,27,0,-27
11935,0,0,59,0,-59
11936,0,0,39,0,-39
11937,0,0,89,0,-89
11938,0,0,42,0,-42
11939,1,0,73,0,-73
11940,0,0,23,0,-23
11941,0,0,38,0,-38
11942,1,0,3,0,-3
11943,0,0,77,0,-77
11944,1,1,458,1546,1088
11945,0,0,8,0,-8
11946,0,0,76,0,-76
11947,0,0,17,0,-17
11948,1,1,293,1237,944
11949,1,1,380,2161,1781
11950,1,0,96,0,-96
11951,1,0,45,0,-45
11952,0,0,36,0,-36
11953,1,0,154,0,-154
11954,1,1,1035,1666,631
11955,1,0,4,0,-4
11956,1,0,13,0,-13
11957,0,0,14,0,-14
11958,1,1,1348,1222,-126
11959,0,0,28,0,-28
11960,1,0,12,0,-12
11961,0,0,18,0,-18
11962,1,1,366,1368,1002
11963,1,1,142,1297,1155
11964,1,1,272,1235,963
11965,0,0,65,0,-65
11966,0,0,10,0,-10
11967,0,0,68,0,-68
11968,1,0,46,0,-46
11969,1,1,141,1398,1257
11970,0,0,104,0,-104
11971,1,0,48,0,-48
11972,1,0,66,0,-66
11973,1,0,28,0,-28
11974,1,1,1032,1589,557
11975,0,0,103,0,-103
11976,1,0,87,0,-87
11977,1,1,304,1322,1018
11978,1,1,93,1563,1470
11979,1,1,216,1388,1172
11980,1,0,127,0,-127
11981,0,0,4,0,-4
11982,0,0,0,0,0
11983,0,0,106,0,-106
11984,0,0,1,0,-1
11985,1,1,1197,1550,353
11986,1,1,222,1367,1145
11987,1,1,195,1706,1511
11988,1,0,48,0,-48
11989,1,0,56,0,-56
11990,1,1,718,1572,854
11991,0,0,9,0,-9
11992,1,1,149,1491,1342
11993,0,0,113,0,-113
11994,0,0,11,0,-11
11995,1,1,235,1382,1147
11996,1,1,174,1471,1297
11997,0,0,169,0,-169
11998,1,0,31,0,-31
11999,1,1,213,1554,1341
12000,0,0,78,0,-78
12001,1,0,78,0,-78
12002,0,0,63,0,-63
12003,0,0,154,0,-154
12004,1,0,74,0,-74
12005,1,1,1029,1204,175
12006,1,0,119,0,-119
12007,1,1,487,1510,1023
12008,0,0,248,0,-248
12009,0,0,71,0,-71
12010,1,0,60,0,-60
12011,1,0,14,0,-14
12012,1,1,434,1579,1145
12013,1,0,21,0,-21
12014,0,0,4,0,-4
12015,1,1,533,1225,692
12016,0,0,144,0,-144
12017,1,0,4,0,-4
12018,0,0,21,0,-21
12019,1,1,297,2016,1719
12020,0,0,18,0,-18
12021,0,0,36,0,-36
12022,1,1,212,2744,2532
12023,1,1,523,1345,822
12024,0,0,39,0,-39
12025,1,1,374,1916,1542
12026,1,0,44,0,-44
12027,1,1,559,1383,824
12028,0,0,10,0,-10
12029,0,0,89,0,-89
12030,0,0,74,0,-74
12031,1,1,991,1232,241
12032,0,0,50,0,-50
12033,0,0,116,0,-116
12034,1,1,136,1326,1190
12035,0,0,42,0,-42
12036,1,1,85,1334,1249
12037,0,0,6,0,-6
12038,1,0,97,0,-97
12039,1,0,61,0,-61
12040,0,0,13,0,-13
12041,1,0,27,0,-27
12042,1,1,432,1349,917
12043,1,0,90,0,-90
12044,0,0,1,0,-1
12045,1,0,143,0,-143
12046,1,1,71,1314,1243
12047,1,0,24,0,-24
12048,1,1,1205,2209,1004
12049,1,1,39,1406,1367
12050,1,0,67,0,-67
12051,1,0,80,0,-80
12052,1,1,50,1659,1609
12053,1,0,88,0,-88
12054,1,0,26,0,-26
12055,1,0,95,0,-95
12056,1,1,332,1355,1023
12057,1,1,1504,1529,25
12058,1,0,6,0,-6
12059,1,1,236,1545,1309
12060,1,0,11,0,-11
12061,0,0,97,0,-97
12062,1,1,64,1471,1407
12063,0,0,88,0,-88
12064,1,1,982,1599,617
12065,1,0,124,0,-124
12066,0,0,22,0,-22
12067,0,0,5,0,-5
12068,0,0,18,0,-18
12069,1,1,313,1398,1085
12070,1,1,182,1315,1133
12071,1,1,763,2939,2176
12072,1,1,157,1247,1090
12073,1,1,186,1286,1100
12074,0,0,42,0,-42
12075,1,0,226,0,-226
12076,0,0,96,0,-96
12077,1,1,714,2121,1407
12078,1,1,313,1239,926
12079,1,1,709,1402,693
12080,0,0,17,0,-17
12081,0,0,32,0,-32
12082,1,1,82,1258,1176
12083,0,0,4,0,-4
12084,0,0,1,0,-1
12085,1,0,134,0,-134
12086,1,0,15,0,-15
12087,1,0,6,0,-6
12088,1,0,193,0,-193
12089,1,0,57,0,-57
12090,1,0,19,0,-19
12091,1,1,232,1320,1088
12092,1,0,14,0,-14
12093,1,1,1649,1929,280
12094,0,0,36,0,-36
12095,1,1,81,1504,1423
12096,0,0,10,0,-10
12097,1,0,22,0,-22
12098,1,0,57,0,-57
12099,0,0,21,0,-21
12100,0,0,55,0,-55
12101,1,0,29,0,-29
12102,0,0,5,0,-5
12103,0,0,34,0,-34
12104,0,0,223,0,-223
12105,1,0,10,0,-10
12106,1,0,7,0,-7
12107,0,0,31,0,-31
12108,1,0,11,0,-11
12109,0,0,3,0,-3
12110,0,0,5,0,-5
12111,1,1,161,3198,3037
12112,1,1,176,2703,2527
12113,1,1,28,1706,1678
12114,0,0,117,0,-117
12115,1,0,77,0,-77
12116,0,0,182,0,-182
12117,1,1,970,1497,527
12118,0,0,2,0,-2
12119,1,0,61,0,-61
12120,0,0,55,0,-55
12121,0,0,49,0,-49
12122,1,0,1,0,-1
12123,1,1,526,1265,739
12124,1,1,219,1437,1218
12125,0,0,45,0,-45
12126,0,0,118,0,-118
12127,1,1,380,3263,2883
12128,0,0,19,0,-19
12129,0,0,41,0,-41
12130,0,0,17,0,-17
12131,1,0,108,0,-108
12132,1,0,38,0,-38
12133,1,0,40,0,-40
12134,1,1,349,1311,962
12135,1,1,415,1971,1556
12136,1,1,1083,1444,361
12137,1,0,33,0,-33
12138,0,0,78,0,-78
12139,1,1,274,1421,1147
12140,1,1,193,1623,1430
12141,1,1,1053,2128,1075
12142,1,1,255,1992,1737
12143,1,0,18,0,-18
12144,1,0,26,0,-26
12145,1,0,33,0,-33
12146,1,0,7,0,-7
12147,0,0,13,0,-13
12148,1,1,71,1590,1519
12149,1,0,9,0,-9
12150,1,0,60,0,-60
12151,0,0,167,0,-167
12152,0,0,138,0,-138
12153,1,0,120,0,-120
12154,1,1,143,1842,1699
12155,0,0,24,0,-24
12156,0,0,135,0,-135
12157,1,0,37,0,-37
12158,1,1,542,1230,688
12159,1,0,16,0,-16
12160,0,0,17,0,-17
12161,1,0,75,0,-75
12162,1,1,840,1459,619
12163,1,1,166,2226,2060
12164,0,0,8,0,-8
12165,0,0,7,0,-7
12166,0,0,68,0,-68
12167,0,0,7,0,-7
12168,1,0,6,0,-6
12169,0,0,9,0,-9
12170,0,0,190,0,-190
12171,0,0,126,0,-126
12172,1,1,321,2280,1959
12173,0,0,6,0,-6
12174,1,1,731,1290,559
12175,1,1,338,2690,2352
12176,0,0,107,0,-107
12177,1,0,49,0,-49
12178,1,0,101,0,-101
12179,1,0,1,0,-1
12180,1,1,189,1389,1200
12181,1,0,130,0,-130
12182,1,0,59,0,-59
12183,1,1,732,1814,1082
12184,0,0,38,0,-38
12185,1,1,1318,1370,52
12186,1,1,587,1222,635
12187,1,0,26,0,-26
12188,1,0,30,0,-30
12189,1,1,1453,1529,76
12190,1,0,11,0,-11
12191,1,0,84,0,-84
12192,0,0,7,0,-7
12193,1,0,80,0,-80
12194,0,0,166,0,-166
12195,1,1,223,1391,1168
12196,1,0,11,0,-11
12197,1,1,275,1315,1040
12198,0,0,83,0,-83
12199,0,0,2,0,-2
12200,1,1,512,1320,808
12201,0,0,55,0,-55
12202,1,0,23,0,-23
12203,1,1,59,1676,1617
12204,1,0,84,0,-84
12205,1,0,8,0,-8
12206,0,0,7,0,-7
12207,1,1,395,1746,1351
12208,1,0,50,0,-50
12209,0,0,28,0,-28
12210,0,0,142,0,-142
12211,0,0,54,0,-54
12212,1,1,1613,1231,-382
12213,1,0,10,0,-10
12214,1,0,44,0,-44
12215,1,1,291,1214,923
12216,1,0,64,0,-64
12217,1,0,71,0,-71
12218,1,0,27,0,-27
12219,0,0,21,0,-21
12220,1,0,0,0,0
12221,1,0,88,0,-88
12222,1,0,3,0,-3
12223,1,1,551,1490,939
12224,0,0,86,0,-86
12225,1,0,11,0,-11
12226,1,1,703,1233,530
12227,0,0,10,0,-10
12228,0,0,78,0,-78
12229,1,0,25,0,-25
12230,0,0,47,0,-47
12231,0,0,52,0,-52
12232,1,1,232,1351,1119
12233,1,0,29,0,-29
12234,1,1,259,1617,1358
12235,0,0,43,0,-43
12236,0,0,7,0,-7
12237,1,1,760,1587,827
12238,1,1,351,1267,916
12239,0,0,24,0,-24
12240,1,0,74,0,-74
12241,1,1,478,1201,723
12242,1,1,1500,2314,814
12243,1,1,156,1320,1164
12244,0,0,12,0,-12
12245,1,0,92,0,-92
12246,1,1,644,1566,922
12247,0,0,15,0,-15
12248,1,0,32,0,-32
12249,1,1,72,1362,1290
12250,0,0,16,0,-16
12251,0,0,20,0,-20
12252,0,0,50,0,-50
12253,1,1,98,1294,1196
12254,1,0,68,0,-68
12255,1,1,1959,1923,-36
12256,1,1,1668,1272,-396
12257,0,0,56,0,-56
12258,0,0,30,0,-30
12259,1,1,1339,2187,848
12260,1,0,22,0,-22
12261,1,1,1881,1416,-465
12262,1,0,55,0,-55
12263,0,0,75,0,-75
12264,1,1,97,2473,2376
12265,1,0,120,0,-120
12266,1,0,35,0,-35
12267,0,0,14,0,-14
12268,0,0,66,0,-66
12269,1,1,378,1432,1054
12270,1,1,240,1288,1048
12271,0,0,16,0,-16
12272,0,0,24,0,-24
12273,1,1,73,1228,1155
12274,1,0,41,0,-41
12275,0,0,52,0,-52
12276,0,0,19,0,-19
12277,0,0,13,0,-13
12278,1,1,119,1560,1441
12279,0,0,15,0,-15
12280,1,1,203,1461,1258
12281,1,1,126,1807,1681
12282,0,0,112,0,-112
12283,1,0,25,0,-25
12284,1,0,20,0,-20
12285,0,0,66,0,-66
12286,1,1,467,1309,842
12287,1,1,365,1715,1350
12288,1,1,1250,1735,485
12289,0,0,25,0,-25
12290,1,0,57,0,-57
12291,1,1,424,1946,1522
12292,1,1,199,1573,1374
12293,0,0,16,0,-16
12294,1,1,924,1643,719
12295,0,0,29,0,-29
12296,0,0,93,0,-93
12297,1,0,1,0,-1
12298,1,0,7,0,-7
12299,0,0,2,0,-2
12300,1,0,24,0,-24
12301,1,1,54,1255,1201
12302,0,0,19,0,-19
12303,1,0,49,0,-49
12304,0,0,48,0,-48
12305,1,0,15,0,-15
12306,1,0,14,0,-14
12307,0,0,10,0,-10
12308,0,0,2,0,-2
12309,0,0,15,0,-15
12310,1,0,44,0,-44
12311,1,0,26,0,-26
12312,0,0,46,0,-46
12313,0,0,14,0,-14
12314,1,1,341,2789,2448
12315,0,0,49,0,-49
12316,1,0,163,0,-163
12317,1,0,0,0,0
12318,1,1,319,1340,1021
12319,1,1,413,1235,822
12320,1,0,0,0,0
12321,1,1,127,2053,1926
12322,1,0,10,0,-10
12323,0,0,164,0,-164
12324,1,1,385,1262,877
12325,1,1,1036,2046,1010
12326,1,1,566,1223,657
12327,0,0,94,0,-94
12328,1,0,27,0,-27
12329,0,0,56,0,-56
12330,1,0,23,0,-23
12331,1,0,41,0,-41
12332,1,1,266,1796,1530
12333,1,1,78,1358,1280
12334,0,0,6,0,-6
12335,1,1,318,1232,914
12336,1,1,251,1240,989
12337,1,1,404,1215,811
12338,0,0,46,0,-46
12339,1,0,94,0,-94
12340,1,1,1117,1646,529
12341,1,0,79,0,-79
12342,1,0,33,0,-33
12343,1,1,755,1503,748
12344,1,0,10,0,-10
12345,0,0,54,0,-54
12346,0,0,44,0,-44
12347,1,0,25,0,-25
12348,0,0,67,0,-67
12349,0,0,7,0,-7
12350,1,0,16,0,-16
12351,0,0,23,0,-23
12352,1,1,92,1293,1201
12353,0,0,25,0,-25
12354,1,1,713,1339,626
12355,1,0,52,0,-52
12356,1,1,576,1299,723
12357,0,0,21,0,-21
12358,0,0,53,0,-53
12359,1,0,58,0,-58
12360,0,0,44,0,-44
12361,0,0,38,0,-38
12362,0,0,50,0,-50
12363,0,0,116,0,-116
12364,0,0,38,0,-38
12365,1,1,253,2048,1795
12366,0,0,6,0,-6
12367,1,0,19,0,-19
12368,1,0,5,0,-5
12369,1,0,119,0,-119
12370,1,0,173,0,-173
12371,1,1,615,1381,766
12372,1,1,688,1591,903
12373,0,0,27,0,-27
12374,1,1,1170,2388,1218
12375,1,0,13,0,-13
12376,0,0,32,0,-32
12377,0,0,81,0,-81
12378,1,1,254,1284,1030
12379,0,0,8,0,-8
12380,0,0,15,0,-15
12381,1,1,38,1981,1943
12382,1,1,267,1224,957
12383,1,1,121,2005,1884
12384,0,0,3,0,-3
12385,0,0,15,0,-15
12386,1,0,33,0,-33
12387,1,0,12,0,-12
12388,1,1,170,1475,1305
12389,1,1,187,1314,1127
12390,0,0,11,0,-11
12391,1,0,6,0,-6
12392,0,0,75,0,-75
12393,1,1,650,1283,633
12394,1,0,19,0,-19
12395,0,0,49,0,-49
12396,0,0,149,0,-149
12397,0,0,20,0,-20
12398,0,0,5,0,-5
12399,1,0,125,0,-125
12400,1,0,22,0,-22
12401,1,1,96,2657,2561
12402,1,1,284,1230,946
12403,0,0,45,0,-45
12404,0,0,9,0,-9
12405,0,0,145,0,-145
12406,1,1,73,1398,1325
12407,0,0,9,0,-9
12408,1,1,116,1236,1120
12409,1,1,1479,1373,-106
12410,1,1,689,2139,1450
12411,1,0,66,0,-66
12412,1,1,1931,1245,-686
12413,0,0,0,0,0
12414,1,0,61,0,-61
12415,0,0,11,0,-11
12416,1,1,141,1220,1079
12417,0,0,21,0,-21
12418,0,0,39,0,-39
12419,0,0,7,0,-7
12420,0,0,69,0,-69
12421,0,0,67,0,-67
12422,1,0,18,0,-18
12423,0,0,13,0,-13
12424,1,0,54,0,-54
12425,1,0,60,0,-60
12426,1,0,19,0,-19
12427,0,0,6,0,-6
12428,0,0,48,0,-48
12429,1,1,966,1208,242
12430,0,0,54,0,-54
12431,1,0,130,0,-130
12432,1,0,19,0,-19
12433,1,1,217,1210,993
12434,1,0,22,0,-22
12435,0,0,18,0,-18
12436,1,0,19,0,-19
12437,1,1,200,1353,1153
12438,0,0,16,0,-16
12439,0,0,93,0,-93
12440,1,0,19,0,-19
12441,1,1,842,1865,1023
12442,0,0,16,0,-16
12443,0,0,7,0,-7
12444,1,0,35,0,-35
12445,0,0,179,0,-179
12446,0,0,2,0,-2
12447,1,1,1182,1248,66
12448,0,0,49,0,-49
12449,0,0,160,0,-160
12450,1,0,22,0,-22
12451,1,1,334,1324,990
12452,1,1,311,1540,1229
12453,0,0,7,0,-7
12454,0,0,45,0,-45
12455,1,0,62,0,-62
12456,0,0,77,0,-77
12457,0,0,48,0,-48
12458,0,0,40,0,-40
12459,1,0,26,0,-26
12460,1,1,868,1702,834
12461,0,0,27,0,-27
12462,0,0,53,0,-53
12463,0,0,125,0,-125
12464,1,1,323,1491,1168
12465,1,0,37,0,-37
12466,1,1,203,1371,1168
12467,0,0,225,0,-225
12468,0,0,25,0,-25
12469,0,0,9,0,-9
12470,0,0,6,0,-6
12471,1,0,108,0,-108
12472,1,1,520,1240,720
12473,1,1,223,1443,1220
12474,1,1,719,1873,1154
12475,1,1,264,1259,995
12476,0,0,52,0,-52
12477,1,1,1506,1341,-165
12478,0,0,1,0,-1
12479,1,0,79,0,-79
12480,1,0,26,0,-26
12481,0,0,19,0,-19
12482,1,0,6,0,-6
12483,0,0,17,0,-17
12484,1,0,35,0,-35
12485,1,0,65,0,-65
12486,0,0,193,0,-193
12487,1,1,281,1358,1077
12488,1,1,556,1401,845
12489,1,1,1200,1277,77
12490,1,0,23,0,-23
12491,0,0,8,0,-8
12492,0,0,25,0,-25
12493,1,0,33,0,-33
12494,1,0,6,0,-6
12495,0,0,4,0,-4
12496,1,1,635,1334,699
12497,0,0,44,0,-44
12498,1,1,330,1916,1586
12499,1,0,26,0,-26
12500,1,0,58,0,-58
12501,1,0,69,0,-69
12502,1,1,620,1588,968
12503,1,1,405,1450,1045
12504,1,1,581,1532,951
12505,0,0,17,0,-17
12506,0,0,29,0,-29
12507,1,0,18,0,-18
12508,1,1,33,1468,1435
12509,1,0,76,0,-76
12510,1,0,29,0,-29
12511,0,0,5,0,-5
12512,0,0,14,0,-14
12513,1,1,825,1293,468
12514,0,0,4,0,-4
12515,1,0,101,0,-101
12516,1,1,279,1766,1487
12517,0,0,20,0,-20
12518,0,0,8,0,-8
12519,0,0,7,0,-7
12520,0,0,62,0,-62
12521,0,0,6,0,-6
12522,0,0,75,0,-75
12523,1,0,53,0,-53
12524,0,0,19,0,-19
12525,0,0,69,0,-69
12526,0,0,27,0,-27
12527,0,0,2,0,-2
12528,1,0,108,0,-108
12529,1,1,210,1871,1661
12530,0,0,5,0,-5
12531,1,1,1416,1602,186
12532,1,0,98,0,-98
12533,0,0,56,0,-56
12534,0,0,57,0,-57
12535,0,0,141,0,-141
12536,0,0,76,0,-76
12537,1,1,551,1680,1129
12538,1,0,37,0,-37
12539,0,0,124,0,-124
12540,0,0,152,0,-152
12541,0,0,67,0,-67
12542,0,0,62,0,-62
12543,1,1,226,1516,1290
12544,0,0,129,0,-129
12545,1,1,869,1222,353
12546,1,1,515,1782,1267
12547,1,0,22,0,-22
12548,1,0,12,0,-12
12549,1,0,21,0,-21
12550,1,0,48,0,-48
12551,0,0,172,0,-172
12552,1,0,10,0,-10
12553,0,0,88,0,-88
12554,0,0,97,0,-97
12555,1,0,38,0,-38
12556,0,0,177,0,-177
12557,1,1,143,1441,1298
12558,1,1,435,1355,920
12559,0,0,94,0,-94
12560,0,0,85,0,-85
12561,0,0,70,0,-70
12562,1,0,244,0,-244
12563,1,0,94,0,-94
12564,0,0,31,0,-31
12565,0,0,97,0,-97
12566,0,0,27,0,-27
12567,0,0,13,0,-13
12568,0,0,24,0,-24
12569,0,0,47,0,-47
12570,0,0,12,0,-12
12571,1,0,46,0,-46
12572,0,0,5,0,-5
12573,0,0,59,0,-59
12574,0,0,31,0,-31
12575,1,1,211,1413,1202
12576,1,0,54,0,-54
12577,1,0,76,0,-76
12578,1,1,133,1325,1192
12579,1,0,45,0,-45
12580,1,1,303,1648,1345
12581,1,0,51,0,-51
12582,0,0,6,0,-6
12583,1,0,65,0,-65
12584,1,1,368,1561,1193
12585,0,0,50,0,-50
12586,1,0,14,0,-14
12587,1,1,2934,1912,-1022
12588,1,1,244,1293,1049
12589,0,0,34,0,-34
12590,1,0,136,0,-136
12591,0,0,339,0,-339
12592,0,0,50,0,-50
12593,1,1,348,1276,928
12594,0,0,38,0,-38
12595,1,0,116,0,-116
12596,1,0,113,0,-113
12597,1,0,30,0,-30
12598,1,0,148,0,-148
12599,1,0,97,0,-97
12600,1,1,1068,1307,239
12601,1,1,737,1459,722
12602,1,0,16,0,-16
12603,1,0,9,0,-9
12604,0,0,3,0,-3
12605,0,0,29,0,-29
12606,0,0,1,0,-1
12607,1,0,28,0,-28
12608,0,0,6,0,-6
12609,1,0,90,0,-90
12610,1,1,274,1590,1316
12611,1,1,409,1263,854
12612,0,0,14,0,-14
12613,0,0,11,0,-11
12614,1,0,19,0,-19
12615,1,1,318,1220,902
12616,0,0,51,0,-51
12617,1,0,29,0,-29
12618,1,1,642,1225,583
12619,1,1,146,1209,1063
12620,0,0,126,0,-126
12621,0,0,62,0,-62
12622,1,0,44,0,-44
12623,0,0,79,0,-79
12624,0,0,18,0,-18
12625,0,0,1,0,-1
12626,0,0,138,0,-138
12627,0,0,39,0,-39
12628,0,0,31,0,-31
12629,0,0,110,0,-110
12630,0,0,53,0,-53
12631,1,1,833,1891,1058
12632,0,0,84,0,-84
12633,1,0,9,0,-9
12634,0,0,92,0,-92
12635,1,1,146,1447,1301
12636,0,0,38,0,-38
12637,1,1,345,1398,1053
12638,0,0,26,0,-26
12639,1,1,60,1501,1441
12640,1,1,340,1304,964
12641,0,0,66,0,-66
12642,1,0,3,0,-3
12643,0,0,59,0,-59
12644,0,0,22,0,-22
12645,1,1,947,1325,378
12646,1,1,218,1240,1022
12647,1,1,1031,2220,1189
12648,1,1,458,1345,887
12649,0,0,2,0,-2
12650,0,0,16,0,-16
12651,1,1,64,1284,1220
12652,0,0,50,0,-50
12653,1,0,16,0,-16
12654,1,1,391,1248,857
12655,1,0,358,0,-358
12656,1,1,780,3172,2392
12657,1,1,721,1722,1001
12658,1,1,351,1837,1486
12659,1,1,410,1613,1203
12660,0,0,113,0,-113
12661,0,0,15,0,-15
12662,0,0,71,0,-71
12663,1,1,144,3295,3151
12664,1,0,27,0,-27
12665,0,0,36,0,-36
12666,0,0,1,0,-1
12667,0,0,19,0,-19
12668,1,1,424,1244,820
12669,1,0,57,0,-57
12670,1,1,185,1255,1070
12671,1,0,48,0,-48
12672,1,0,6,0,-6
12673,1,1,485,1462,977
12674,1,1,442,1235,793
12675,1,0,42,0,-42
12676,1,1,725,1657,932
12677,1,1,106,1211,1105
12678,1,1,712,1361,649
12679,1,0,8,0,-8
12680,1,0,98,0,-98
12681,1,0,98,0,-98
12682,0,0,8,0,-8
12683,0,0,118,0,-118
12684,0,0,32,0,-32
12685,0,0,135,0,-135
12686,1,1,325,1548,1223
12687,0,0,41,0,-41
12688,1,0,8,0,-8
12689,0,0,7,0,-7
12690,1,1,127,1317,1190
12691,0,0,16,0,-16
12692,0,0,17,0,-17
12693,0,0,73,0,-73
12694,1,1,227,2176,1949
12695,1,1,67,1577,1510
12696,1,0,67,0,-67
12697,1,1,638,1405,767
12698,1,0,94,0,-94
12699,1,1,1199,1647,448
12700,1,1,155,1462,1307
12701,1,1,1196,1204,8
12702,1,0,22,0,-22
12703,1,1,430,1465,1035
12704,1,0,6,0,-6
12705,1,1,1169,1598,429
12706,0,0,18,0,-18
12707,1,0,98,0,-98
12708,1,0,180,0,-180
12709,0,0,130,0,-130
12710,0,0,5,0,-5
12711,0,0,112,0,-112
12712,0,0,107,0,-107
12713,0,0,63,0,-63
12714,0,0,119,0,-119
12715,1,0,49,0,-49
12716,0,0,31,0,-31
12717,0,0,133,0,-133
12718,0,0,40,0,-40
12719,0,0,2,0,-2
12720,0,0,2,0,-2
12721,0,0,21,0,-21
12722,0,0,59,0,-59
12723,0,0,45,0,-45
12724,1,0,87,0,-87
12725,0,0,37,0,-37
12726,0,0,61,0,-61
12727,1,0,8,0,-8
12728,0,0,13,0,-13
12729,0,0,166,0,-166
12730,0,0,4,0,-4
12731,1,0,69,0,-69
12732,1,1,418,2082,1664
12733,1,1,195,2344,2149
12734,1,0,27,0,-27
12735,1,1,59,1252,1193
12736,1,0,141,0,-141
12737,0,0,53,0,-53
12738,1,0,86,0,-86
12739,1,0,42,0,-42
12740,1,1,1039,1435,396
12741,0,0,1,0,-1
12742,1,0,53,0,-53
12743,1,1,12,1284,1272
12744,0,0,30,0,-30
12745,0,0,86,0,-86
12746,0,0,41,0,-41
12747,1,1,232,1454,1222
12748,0,0,86,0,-86
12749,0,0,61,0,-61
12750,1,0,13,0,-13
12751,0,0,21,0,-21
12752,1,1,623,1249,626
12753,1,1,459,1268,809
12754,1,1,56,1361,1305
12755,1,1,283,1920,1637
12756,0,0,18,0,-18
12757,0,0,24,0,-24
12758,1,1,958,1358,400
12759,0,0,37,0,-37
12760,0,0,32,0,-32
12761,1,0,73,0,-73
12762,1,0,61,0,-61
12763,1,1,242,1864,1622
12764,1,1,742,1216,474
12765,1,1,1060,1772,712
12766,1,1,676,1924,1248
12767,0,0,39,0,-39
12768,0,0,0,0,0
12769,0,0,22,0,-22
12770,1,0,25,0,-25
12771,1,0,23,0,-23
12772,1,0,136,0,-136
12773,0,0,86,0,-86
12774,0,0,29,0,-29
12775,0,0,211,0,-211
12776,1,1,140,1281,1141
12777,1,1,211,1244,1033
12778,1,1,186,1680,1494
12779,0,0,126,0,-126
12780,0,0,2,0,-2
12781,1,0,80,0,-80
12782,1,1,71,1480,1409
12783,1,0,10,0,-10
12784,1,0,73,0,-73
12785,0,0,108,0,-108
12786,1,0,73,0,-73
12787,0,0,5,0,-5
12788,1,1,153,1356,1203
12789,1,1,682,1353,671
12790,1,0,36,0,-36
12791,0,0,5,0,-5
12792,1,0,2,0,-2
12793,1,0,1,0,-1
12794,0,0,6,0,-6
12795,0,0,32,0,-32
12796,0,0,4,0,-4
12797,0,0,73,0,-73
12798,1,1,559,2042,1483
12799,1,1,630,1217,587
12800,1,0,45,0,-45
12801,0,0,29,0,-29
12802,0,0,72,0,-72
12803,0,0,29,0,-29
12804,1,1,835,1299,464
12805,1,1,196,1860,1664
12806,1,1,687,1655,968
12807,1,0,21,0,-21
12808,1,1,231,1386,1155
12809,1,0,20,0,-20
12810,1,1,655,1230,575
12811,0,0,30,0,-30
12812,1,1,154,1442,1288
12813,1,1,1549,1548,-1
12814,1,1,517,1780,1263
12815,0,0,7,0,-7
12816,1,0,51,0,-51
12817,1,0,8,0,-8
12818,0,0,67,0,-67
12819,1,1,939,1389,450
12820,0,0,2,0,-2
12821,1,1,814,1427,613
12822,0,0,45,0,-45
12823,0,0,0,0,0
12824,1,0,32,0,-32
12825,0,0,24,0,-24
12826,0,0,12,0,-12
12827,0,0,17,0,-17
12828,0,0,58,0,-58
12829,1,1,324,1376,1052
12830,1,0,106,0,-106
12831,1,0,8,0,-8
12832,1,1,817,1645,828
12833,1,0,2,0,-2
12834,1,0,28,0,-28
12835,0,0,66,0,-66
12836,1,1,856,1502,646
12837,0,0,136,0,-136
12838,0,0,18,0,-18
12839,0,0,10,0,-10
12840,1,1,1110,1355,245
12841,1,1,1017,1468,451
12842,1,1,277,2994,2717
12843,1,0,17,0,-17
12844,0,0,10,0,-10
12845,1,1,348,1257,909
12846,0,0,78,0,-78
12847,1,1,347,1371,1024
12848,1,1,407,1683,1276
12849,0,0,13,0,-13
12850,1,0,62,0,-62
12851,1,0,23,0,-23
12852,1,1,147,1588,1441
12853,1,0,11,0,-11
12854,1,1,473,1794,1321
12855,1,0,6,0,-6
12856,0,0,13,0,-13
12857,1,1,1629,1580,-49
12858,0,0,42,0,-42
12859,1,1,432,1327,895
12860,1,0,114,0,-114
12861,0,0,29,0,-29
12862,1,1,481,1761,1280
12863,0,0,10,0,-10
12864,1,1,137,1250,1113
12865,0,0,89,0,-89
12866,0,0,34,0,-34
12867,0,0,67,0,-67
12868,1,1,383,1371,988
12869,1,1,517,1205,688
12870,1,1,842,1301,459
12871,0,0,77,0,-77
12872,1,0,60,0,-60
12873,1,1,656,1203,547
12874,1,0,29,0,-29
12875,1,1,1116,2099,983
12876,1,0,28,0,-28
12877,0,0,33,0,-33
12878,0,0,0,0,0
12879,1,0,123,0,-123
12880,1,1,549,1203,654
12881,0,0,45,0,-45
12882,1,1,177,1248,1071
12883,1,1,518,2226,1708
12884,1,0,33,0,-33
12885,1,0,1,0,-1
12886,0,0,34,0,-34
12887,1,0,18,0,-18
12888,0,0,15,0,-15
12889,1,1,840,2185,1345
12890,0,0,54,0,-54
12891,1,1,1186,2286,1100
12892,1,0,26,0,-26
12893,0,0,44,0,-44
12894,1,1,34,3304,3270
12895,1,1,409,1437,1028
12896,1,0,21,0,-21
12897,0,0,13,0,-13
12898,1,0,44,0,-44
12899,1,0,175,0,-175
12900,1,1,446,1360,914
12901,0,0,15,0,-15
12902,1,0,15,0,-15
12903,1,1,775,2578,1803
12904,0,0,24,0,-24
12905,0,0,95,0,-95
12906,1,0,2,0,-2
12907,1,0,33,0,-33
12908,1,0,2,0,-2
12909,0,0,5,0,-5
12910,0,0,12,0,-12
12911,1,1,734,1798,1064
12912,1,1,1443,1244,-199
12913,0,0,12,0,-12
12914,1,1,249,1849,1600
12915,0,0,19,0,-19
12916,1,0,26,0,-26
12917,0,0,63,0,-63
12918,1,0,28,0,-28
12919,0,0,161,0,-161
12920,0,0,31,0,-31
12921,0,0,10,0,-10
12922,1,1,2108,1234,-874
12923,1,1,566,1635,1069
12924,1,0,32,0,-32
12925,1,0,49,0,-49
12926,1,0,19,0,-19
12927,1,0,0,0,0
12928,1,1,280,1836,1556
12929,0,0,1,0,-1
12930,0,0,35,0,-35
12931,1,0,23,0,-23
12932,1,1,207,6823,6616
12933,1,0,13,0,-13
12934,0,0,22,0,-22
12935,1,0,29,0,-29
12936,0,0,5,0,-5
12937,1,0,142,0,-142
12938,1,0,10,0,-10
12939,1,1,428,1609,1181
12940,1,0,87,0,-87
12941,1,0,150,0,-150
12942,1,1,321,3843,3522
12943,1,1,245,1317,1072
12944,1,0,14,0,-14
12945,0,0,29,0,-29
12946,1,1,138,1271,1133
12947,0,0,116,0,-116
12948,0,0,109,0,-109
12949,0,0,18,0,-18
12950,1,1,732,1921,1189
12951,0,0,24,0,-24
12952,1,1,2537,1356,-1181
12953,1,1,169,1519,1350
12954,0,0,12,0,-12
12955,1,0,80,0,-80
12956,1,0,8,0,-8
12957,0,0,140,0,-140
12958,0,0,29,0,-29
12959,1,1,146,1679,1533
12960,0,0,45,0,-45
12961,1,1,641,2316,1675
12962,0,0,8,0,-8
12963,1,1,470,1707,1237
12964,1,0,18,0,-18
12965,1,1,241,1222,981
12966,1,1,1720,1370,-350
12967,1,0,88,0,-88
12968,0,0,89,0,-89
12969,1,1,552,1251,699
12970,1,0,21,0,-21
12971,0,0,7,0,-7
12972,0,0,344,0,-344
12973,1,1,1256,1716,460
12974,1,0,90,0,-90
12975,1,1,681,1416,735
12976,0,0,93,0,-93
12977,0,0,5,0,-5
12978,0,0,14,0,-14
12979,1,1,648,2115,1467
12980,0,0,46,0,-46
12981,0,0,50,0,-50
12982,1,1,1734,1331,-403
12983,0,0,3,0,-3
12984,1,1,55,1209,1154
12985,0,0,3,0,-3
12986,0,0,25,0,-25
12987,1,1,1025,1671,646
12988,1,0,6,0,-6
12989,1,1,500,1448,948
12990,1,1,684,1531,847
12991,0,0,89,0,-89
12992,1,0,10,0,-10
12993,0,0,0,0,0
12994,0,0,78,0,-78
12995,1,0,38,0,-38
12996,0,0,16,0,-16
12997,1,0,28,0,-28
12998,1,1,461,1477,1016
12999,1,0,89,0,-89
13000,1,0,70,0,-70
13001,1,1,289,1383,1094
13002,1,1,1025,1322,297
13003,0,0,25,0,-25
13004,1,1,271,1440,1169
13005,1,1,1157,1702,545
13006,1,0,3,0,-3
13007,1,1,385,1446,1061
13008,1,0,33,0,-33
13009,1,0,114,0,-114
13010,0,0,92,0,-92
13011,0,0,161,0,-161
13012,1,0,31,0,-31
13013,1,0,26,0,-26
13014,0,0,14,0,-14
13015,1,1,1003,2119,1116
13016,1,1,340,1363,1023
13017,1,0,54,0,-54
13018,0,0,91,0,-91
13019,0,0,5,0,-5
13020,1,0,36,0,-36
13021,1,0,20,0,-20
13022,0,0,32,0,-32
13023,1,0,61,0,-61
13024,0,0,43,0,-43
13025,1,0,21,0,-21
13026,0,0,16,0,-16
13027,1,1,1238,2021,783
13028,1,1,123,1225,1102
13029,0,0,14,0,-14
13030,1,0,80,0,-80
13031,0,0,58,0,-58
13032,1,0,25,0,-25
13033,1,1,551,1942,1391
13034,1,0,27,0,-27
13035,1,1,109,1323,1214
13036,0,0,7,0,-7
13037,0,0,57,0,-57
13038,1,0,77,0,-77
13039,0,0,75,0,-75
13040,0,0,68,0,-68
13041,1,0,66,0,-66
13042,0,0,5,0,-5
13043,0,0,52,0,-52
13044,1,1,1972,1593,-379
13045,0,0,9,0,-9
13046,0,0,144,0,-144
13047,0,0,75,0,-75
13048,0,0,92,0,-92
13049,0,0,54,0,-54
13050,0,0,38,0,-38
13051,0,0,45,0,-45
13052,1,0,30,0,-30
13053,0,0,8,0,-8
13054,0,0,1,0,-1
13055,1,1,55,1522,1467
13056,1,1,32,1421,1389
13057,0,0,228,0,-228
13058,1,0,0,0,0
13059,1,1,154,2141,1987
13060,1,0,22,0,-22
13061,1,0,68,0,-68
13062,0,0,57,0,-57
13063,1,0,19,0,-19
13064,1,1,554,1493,939
13065,0,0,15,0,-15
13066,0,0,12,0,-12
13067,1,0,43,0,-43
13068,1,0,45,0,-45
13069,0,0,43,0,-43
13070,1,0,13,0,-13
13071,1,1,865,1671,806
13072,0,0,47,0,-47
13073,1,0,57,0,-57
13074,0,0,0,0,0
13075,1,1,158,1285,1127
13076,1,0,23,0,-23
13077,1,1,188,1704,1516
13078,0,0,7,0,-7
13079,0,0,34,0,-34
13080,0,0,16,0,-16
13081,1,1,265,1819,1554
13082,1,0,7,0,-7
13083,0,0,78,0,-78
13084,0,0,38,0,-38
13085,0,0,41,0,-41
13086,1,0,21,0,-21
13087,1,1,273,1203,930
13088,1,0,55,0,-55
13089,1,1,555,1716,1161
13090,0,0,100,0,-100
13091,1,1,1084,1738,654
13092,0,0,3,0,-3
13093,1,1,165,1891,1726
13094,0,0,114,0,-114
13095,1,0,2,0,-2
13096,0,0,85,0,-85
13097,1,0,15,0,-15
13098,1,0,7,0,-7
13099,1,0,55,0,-55
13100,0,0,18,0,-18
13101,1,0,0,0,0
13102,1,1,106,1631,1525
13103,1,0,18,0,-18
13104,0,0,9,0,-9
13105,1,1,226,1205,979
13106,0,0,192,0,-192
13107,1,0,46,0,-46
13108,1,0,0,0,0
13109,0,0,88,0,-88
13110,1,1,202,1220,1018
13111,1,0,41,0,-41
13112,0,0,33,0,-33
13113,1,0,195,0,-195
13114,1,1,874,1380,506
13115,1,0,19,0,-19
13116,1,1,362,2169,1807
13117,1,0,0,0,0
13118,1,1,17,1562,1545
13119,1,0,14,0,-14
13120,1,1,46,1215,1169
13121,1,0,0,0,0
13122,0,0,82,0,-82
13123,1,0,5,0,-5
13124,0,0,14,0,-14
13125,0,0,50,0,-50
13126,1,1,1593,2101,508
13127,0,0,6,0,-6
13128,0,0,118,0,-118
13129,0,0,66,0,-66
13130,1,0,1,0,-1
13131,0,0,8,0,-8
13132,0,0,0,0,0
13133,1,1,51,1378,1327
13134,0,0,58,0,-58
13135,1,1,262,1286,1024
13136,0,0,26,0,-26
13137,1,0,59,0,-59
13138,0,0,23,0,-23
13139,0,0,73,0,-73
13140,0,0,81,0,-81
13141,1,0,36,0,-36
13142,1,0,90,0,-90
13143,1,1,560,1525,965
13144,1,0,16,0,-16
13145,1,1,80,1626,1546
13146,1,1,211,1363,1152
13147,0,0,1,0,-1
13148,1,0,3,0,-3
13149,1,1,379,1269,890
13150,0,0,55,0,-55
13151,0,0,55,0,-55
13152,1,1,451,3085,2634
13153,1,0,17,0,-17
13154,1,1,346,1237,891
13155,0,0,231,0,-231
13156,1,0,8,0,-8
13157,1,0,23,0,-23
13158,1,1,824,1757,933
13159,0,0,13,0,-13
13160,0,0,100,0,-100
13161,1,0,13,0,-13
13162,0,0,43,0,-43
13163,1,0,83,0,-83
13164,0,0,21,0,-21
13165,0,0,5,0,-5
13166,0,0,3,0,-3
13167,1,0,164,0,-164
13168,0,0,13,0,-13
13169,0,0,42,0,-42
13170,1,0,61,0,-61
13171,1,0,81,0,-81
13172,1,1,698,1208,510
13173,0,0,58,0,-58
13174,1,0,50,0,-50
13175,0,0,31,0,-31
13176,1,1,580,1262,682
13177,0,0,22,0,-22
13178,0,0,0,0,0
13179,0,0,8,0,-8
13180,1,0,46,0,-46
13181,0,0,39,0,-39
13182,1,1,407,1523,1116
13183,0,0,4,0,-4
13184,1,0,79,0,-79
13185,0,0,42,0,-42
13186,1,1,1206,1582,376
13187,1,1,786,1204,418
13188,1,1,376,1280,904
13189,0,0,76,0,-76
13190,0,0,8,0,-8
13191,1,0,11,0,-11
13192,1,1,532,1607,1075
13193,1,1,397,1395,998
13194,1,0,37,0,-37
13195,1,0,39,0,-39
13196,1,1,1549,1221,-328
13197,1,0,2,0,-2
13198,0,0,73,0,-73
13199,1,0,63,0,-63
13200,1,1,78,2061,1983
13201,1,0,46,0,-46
13202,0,0,12,0,-12
13203,1,1,1325,1649,324
13204,1,1,216,1586,1370
13205,0,0,22,0,-22
13206,1,0,33,0,-33
13207,0,0,42,0,-42
13208,0,0,52,0,-52
13209,1,1,213,1398,1185
13210,0,0,23,0,-23
13211,1,0,86,0,-86
13212,1,1,62,1322,1260
13213,0,0,96,0,-96
13214,0,0,13,0,-13
13215,0,0,138,0,-138
13216,1,1,267,1402,1135
13217,1,0,115,0,-115
13218,1,0,3,0,-3
13219,1,1,361,1516,1155
13220,0,0,1,0,-1
13221,0,0,47,0,-47
13222,1,0,33,0,-33
13223,0,0,32,0,-32
13224,1,1,1143,1323,180
13225,0,0,35,0,-35
13226,0,0,10,0,-10
13227,1,1,396,1822,1426
13228,0,0,89,0,-89
13229,0,0,23,0,-23
13230,1,0,76,0,-76
13231,0,0,178,0,-178
13232,1,0,0,0,0
13233,1,0,131,0,-131
13234,1,0,9,0,-9
13235,1,1,678,1442,764
13236,1,1,1473,1215,-258
13237,0,0,16,0,-16
13238,1,0,19,0,-19
13239,1,1,1232,1308,76
13240,0,0,83,0,-83
13241,1,0,77,0,-77
13242,0,0,59,0,-59
13243,1,1,725,1258,533
13244,1,0,36,0,-36
13245,1,1,253,1245,992
13246,1,1,100,10679,10579
13247,0,0,34,0,-34
13248,0,0,25,0,-25
13249,0,0,217,0,-217
13250,1,0,10,0,-10
13251,1,1,949,1225,276
13252,0,0,43,0,-43
13253,1,1,172,1483,1311
13254,0,0,70,0,-70
13255,1,0,37,0,-37
13256,1,1,372,1382,1010
13257,0,0,53,0,-53
13258,0,0,53,0,-53
13259,1,0,167,0,-167
13260,0,0,46,0,-46
13261,0,0,7,0,-7
13262,0,0,14,0,-14
13263,0,0,247,0,-247
13264,1,1,248,2204,1956
13265,0,0,8,0,-8
13266,0,0,36,0,-36
13267,1,0,14,0,-14
13268,1,0,75,0,-75
13269,0,0,12,0,-12
13270,0,0,25,0,-25
13271,1,0,1,0,-1
13272,0,0,10,0,-10
13273,0,0,232,0,-232
13274,1,1,1886,1250,-636
13275,1,0,9,0,-9
13276,1,0,65,0,-65
13277,1,0,27,0,-27
13278,0,0,14,0,-14
13279,0,0,19,0,-19
13280,1,0,56,0,-56
13281,1,1,636,1237,601
13282,1,0,98,0,-98
13283,0,0,46,0,-46
13284,0,0,11,0,-11
13285,1,1,1172,1262,90
13286,0,0,19,0,-19
13287,0,0,8,0,-8
13288,1,0,20,0,-20
13289,1,1,745,1743,998
13290,1,1,132,1608,1476
13291,1,1,160,1918,1758
13292,1,1,99,1293,1194
13293,1,0,58,0,-58
13294,1,1,134,1277,1143
13295,0,0,30,0,-30
13296,1,1,330,1964,1634
13297,0,0,1,0,-1
13298,1,0,180,0,-180
13299,1,0,16,0,-16
13300,1,1,798,1241,443
13301,1,0,45,0,-45
13302,0,0,72,0,-72
13303,1,1,29,1274,1245
13304,1,0,61,0,-61
13305,0,0,0,0,0
13306,1,1,329,4180,3851
13307,1,0,17,0,-17
13308,1,1,691,1302,611
13309,1,0,11,0,-11
13310,1,1,152,1326,1174
13311,1,0,260,0,-260
13312,1,1,397,1424,1027
13313,1,0,14,0,-14
13314,0,0,11,0,-11
13315,1,0,15,0,-15
13316,0,0,90,0,-90
13317,1,1,759,1287,528
13318,0,0,212,0,-212
13319,1,0,79,0,-79
13320,1,0,16,0,-16
13321,0,0,2,0,-2
13322,1,0,82,0,-82
13323,1,1,423,1579,1156
13324,0,0,44,0,-44
13325,1,0,148,0,-148
13326,0,0,16,0,-16
13327,1,0,38,0,-38
13328,0,0,10,0,-10
13329,1,0,11,0,-11
13330,0,0,35,0,-35
13331,0,0,101,0,-101
13332,0,0,2,0,-2
13333,0,0,13,0,-13
13334,1,1,64,1516,1452
13335,1,1,778,1358,580
13336,1,0,16,0,-16
13337,0,0,20,0,-20
13338,1,1,200,1587,1387
13339,1,0,16,0,-16
13340,1,0,16,0,-16
13341,1,1,283,1231,948
13342,0,0,64,0,-64
13343,0,0,61,0,-61
13344,1,0,112,0,-112
13345,0,0,1,0,-1
13346,1,0,3,0,-3
13347,0,0,130,0,-130
13348,1,0,83,0,-83
13349,0,0,84,0,-84
13350,1,0,15,0,-15
13351,1,1,135,1579,1444
13352,0,0,13,0,-13
13353,1,0,14,0,-14
13354,0,0,25,0,-25
13355,0,0,12,0,-12
13356,1,1,414,1237,823
13357,1,0,20,0,-20
13358,1,1,300,1656,1356
13359,1,1,72,1714,1642
13360,1,1,549,1460,911
13361,1,0,45,0,-45
13362,1,1,657,1762,1105
13363,1,1,419,1424,1005
13364,1,1,840,1478,638
13365,1,1,321,2640,2319
13366,1,1,541,1619,1078
13367,0,0,8,0,-8
13368,1,1,486,1734,1248
13369,1,0,38,0,-38
13370,1,0,57,0,-57
13371,0,0,33,0,-33
13372,1,0,2,0,-2
13373,1,0,84,0,-84
13374,1,1,420,1340,920
13375,1,0,92,0,-92
13376,1,0,55,0,-55
13377,1,1,272,1808,1536
13378,0,0,9,0,-9
13379,0,0,12,0,-12
13380,1,1,984,2110,1126
13381,1,1,149,1276,1127
13382,1,1,581,1498,917
13383,1,0,61,0,-61
13384,1,1,95,1407,1312
13385,1,0,43,0,-43
13386,0,0,35,0,-35
13387,1,1,374,1352,978
13388,0,0,45,0,-45
13389,1,0,60,0,-60
13390,0,0,50,0,-50
13391,0,0,28,0,-28
13392,1,1,247,1442,1195
13393,1,1,299,1413,1114
13394,0,0,108,0,-108
13395,1,1,473,1457,984
13396,1,0,94,0,-94
13397,0,0,91,0,-91
13398,0,0,3,0,-3
13399,0,0,9,0,-9
13400,1,0,227,0,-227
13401,1,1,44,1314,1270
13402,1,1,156,1559,1403
13403,0,0,38,0,-38
13404,0,0,13,0,-13
13405,0,0,125,0,-125
13406,1,1,73,1241,1168
13407,1,1,367,1765,1398
13408,1,0,183,0,-183
13409,1,1,74,1446,1372
13410,1,1,387,1202,815
13411,1,0,89,0,-89
13412,1,1,493,1279,786
13413,0,0,78,0,-78
13414,1,1,173,1276,1103
13415,0,0,6,0,-6
13416,1,0,14,0,-14
13417,1,0,138,0,-138
13418,1,1,1452,1616,164
13419,1,0,38,0,-38
13420,1,0,23,0,-23
13421,1,0,1,0,-1
13422,1,0,6,0,-6
13423,0,0,314,0,-314
13424,0,0,164,0,-164
13425,1,0,5,0,-5
13426,1,0,10,0,-10
13427,1,0,53,0,-53
13428,1,0,99,0,-99
13429,1,1,167,1573,1406
13430,1,1,597,1419,822
13431,1,1,1810,1913,103
13432,0,0,50,0,-50
13433,1,0,1,0,-1
13434,0,0,15,0,-15
13435,1,1,942,1460,518
13436,1,0,4,0,-4
13437,1,1,71,1632,1561
13438,1,1,304,3165,2861
13439,1,1,43,1385,1342
13440,1,1,306,1786,1480
13441,0,0,76,0,-76
13442,0,0,53,0,-53
13443,1,1,817,1323,506
13444,1,0,93,0,-93
13445,0,0,7,0,-7
13446,0,0,9,0,-9
13447,1,0,40,0,-40
13448,0,0,47,0,-47
13449,1,0,2,0,-2
13450,0,0,84,0,-84
13451,0,0,78,0,-78
13452,1,1,627,1784,1157
13453,1,0,48,0,-48
13454,1,0,15,0,-15
13455,1,1,1513,1839,326
13456,0,0,17,0,-17
13457,0,0,12,0,-12
13458,1,1,563,1608,1045
13459,1,1,167,1296,1129
13460,0,0,58,0,-58
13461,1,1,713,1990,1277
13462,0,0,39,0,-39
13463,1,1,541,1359,818
13464,1,0,10,0,-10
13465,1,0,63,0,-63
13466,1,1,312,1230,918
13467,1,1,135,1403,1268
13468,1,0,83,0,-83
13469,1,1,198,1645,1447
13470,1,0,144,0,-144
13471,1,0,34,0,-34
13472,1,0,38,0,-38
13473,0,0,60,0,-60
13474,1,0,15,0,-15
13475,1,1,434,1514,1080
13476,1,0,84,0,-84
13477,1,1,402,1375,973
13478,1,1,1321,1305,-16
13479,1,1,454,1278,824
13480,0,0,2,0,-2
13481,1,0,106,0,-106
13482,1,0,8,0,-8
13483,1,1,1282,1571,289
13484,0,0,45,0,-45
13485,0,0,42,0,-42
13486,1,1,518,1250,732
13487,1,0,65,0,-65
13488,1,0,107,0,-107
13489,1,1,813,1668,855
13490,1,0,54,0,-54
13491,1,1,136,1564,1428
13492,1,0,24,0,-24
13493,1,0,8,0,-8
13494,0,0,15,0,-15
13495,0,0,26,0,-26
13496,1,0,53,0,-53
13497,1,1,1485,1531,46
13498,1,0,12,0,-12
13499,1,1,241,1939,1698
13500,1,0,20,0,-20
13501,1,0,24,0,-24
13502,0,0,62,0,-62
13503,1,1,721,1408,687
13504,1,0,67,0,-67
13505,0,0,61,0,-61
13506,1,1,1022,1653,631
13507,1,1,575,1207,632
13508,1,1,343,1612,1269
13509,1,0,76,0,-76
13510,1,1,356,1203,847
13511,0,0,10,0,-10
13512,1,1,88,1661,1573
13513,0,0,94,0,-94
13514,1,1,154,1318,1164
13515,1,0,17,0,-17
13516,1,0,1,0,-1
13517,1,1,318,1283,965
13518,0,0,10,0,-10
13519,1,0,48,0,-48
13520,1,1,85,1369,1284
13521,0,0,4,0,-4
13522,1,1,573,2440,1867
13523,0,0,6,0,-6
13524,1,0,40,0,-40
13525,0,0,171,0,-171
13526,0,0,34,0,-34
13527,1,0,34,0,-34
13528,0,0,31,0,-31
13529,1,0,12,0,-12
13530,0,0,91,0,-91
13531,0,0,34,0,-34
13532,1,1,846,1249,403
13533,0,0,175,0,-175
13534,1,0,139,0,-139
13535,1,1,945,1272,327
13536,0,0,21,0,-21
13537,1,0,37,0,-37
13538,1,0,13,0,-13
13539,1,1,20,1554,1534
13540,1,1,472,1484,1012
13541,1,0,111,0,-111
13542,1,0,91,0,-91
13543,1,0,37,0,-37
13544,0,0,51,0,-51
13545,0,0,37,0,-37
13546,1,1,352,1651,1299
13547,1,1,226,1280,1054
13548,1,1,948,2658,1710
13549,1,1,582,1292,710
13550,1,1,255,1600,1345
13551,0,0,11,0,-11
13552,0,0,3,0,-3
13553,1,0,14,0,-14
13554,0,0,19,0,-19
13555,1,0,71,0,-71
13556,1,1,1077,1252,175
13557,1,1,28,1243,1215
13558,0,0,97,0,-97
13559,1,0,20,0,-20
13560,0,0,66,0,-66
13561,0,0,13,0,-13
13562,1,0,116,0,-116
13563,1,1,1583,1330,-253
13564,1,1,204,1261,1057
13565,1,1,133,1541,1408
13566,0,0,7,0,-7
13567,0,0,18,0,-18
13568,1,1,143,1273,1130
13569,0,0,49,0,-49
13570,1,0,14,0,-14
13571,1,1,22,1615,1593
13572,1,0,44,0,-44
13573,0,0,40,0,-40
13574,0,0,65,0,-65
13575,0,0,37,0,-37
13576,1,1,72,2338,2266
13577,0,0,21,0,-21
13578,0,0,46,0,-46
13579,1,0,3,0,-3
13580,1,1,729,1696,967
13581,1,0,102,0,-102
13582,0,0,3,0,-3
13583,1,0,96,0,-96
13584,0,0,28,0,-28
13585,1,0,20,0,-20
13586,0,0,18,0,-18
13587,1,0,177,0,-177
13588,1,1,812,1284,472
13589,0,0,44,0,-44
13590,1,1,749,1702,953
13591,0,0,103,0,-103
13592,0,0,20,0,-20
13593,1,0,47,0,-47
13594,1,0,148,0,-148
13595,0,0,11,0,-11
13596,1,0,94,0,-94
13597,0,0,9,0,-9
13598,0,0,19,0,-19
13599,1,0,33,0,-33
13600,0,0,1,0,-1
13601,1,1,451,1284,833
13602,1,0,150,0,-150
13603,0,0,9,0,-9
13604,1,1,1186,1291,105
13605,0,0,30,0,-30
13606,1,1,59,1282,1223
13607,1,0,19,0,-19
13608,1,0,91,0,-91
13609,1,1,241,1596,1355
13610,1,0,20,0,-20
13611,1,0,3,0,-3
13612,1,1,232,1604,1372
13613,1,1,168,1806,1638
13614,0,0,6,0,-6
13615,1,1,195,1273,1078
13616,1,0,79,0,-79
13617,1,1,356,1231,875
13618,0,0,12,0,-12
13619,1,0,25,0,-25
13620,1,1,195,1422,1227
13621,0,0,3,0,-3
13622,0,0,79,0,-79
13623,1,0,15,0,-15
13624,1,0,20,0,-20
13625,0,0,17,0,-17
13626,0,0,27,0,-27
13627,0,0,33,0,-33
13628,0,0,86,0,-86
13629,1,0,2,0,-2
13630,0,0,14,0,-14
13631,1,0,57,0,-57
13632,1,0,35,0,-35
13633,1,0,217,0,-217
13634,1,0,33,0,-33
13635,0,0,29,0,-29
13636,0,0,26,0,-26
13637,1,0,64,0,-64
13638,1,0,27,0,-27
13639,1,0,33,0,-33
13640,0,0,91,0,-91
13641,0,0,101,0,-101
13642,1,0,92,0,-92
13643,0,0,71,0,-71
13644,1,0,29,0,-29
13645,1,1,169,1893,1724
13646,1,0,1,0,-1
13647,1,1,2238,1305,-933
13648,0,0,212,0,-212
13649,0,0,40,0,-40
13650,0,0,48,0,-48
13651,0,0,32,0,-32
13652,1,1,62,1228,1166
13653,0,0,55,0,-55
13654,0,0,94,0,-94
13655,1,1,397,1674,1277
13656,0,0,9,0,-9
13657,0,0,116,0,-116
13658,0,0,40,0,-40
13659,0,0,14,0,-14
13660,1,0,13,0,-13
13661,0,0,18,0,-18
13662,0,0,106,0,-106
13663,0,0,2,0,-2
13664,0,0,5,0,-5
13665,1,0,172,0,-172
13666,0,0,75,0,-75
13667,1,0,120,0,-120
13668,0,0,42,0,-42
13669,1,1,123,1843,1720
13670,1,1,193,2398,2205
13671,1,1,366,1217,851
13672,1,0,61,0,-61
13673,0,0,70,0,-70
13674,1,1,181,1237,1056
13675,1,0,90,0,-90
13676,0,0,111,0,-111
13677,1,1,232,1382,1150
13678,1,1,135,1281,1146
13679,1,1,980,1300,320
13680,0,0,15,0,-15
13681,0,0,39,0,-39
13682,1,1,897,1328,431
13683,1,0,44,0,-44
13684,1,1,314,1786,1472
13685,1,0,1,0,-1
13686,1,0,97,0,-97
13687,1,0,34,0,-34
13688,1,1,461,1861,1400
13689,0,0,19,0,-19
13690,0,0,57,0,-57
13691,1,0,79,0,-79
13692,1,1,542,1457,915
13693,0,0,146,0,-146
13694,1,0,89,0,-89
13695,1,0,14,0,-14
13696,1,1,475,1351,876
13697,0,0,34,0,-34
13698,0,0,65,0,-65
13699,0,0,28,0,-28
13700,1,1,1714,1250,-464
13701,1,1,87,1341,1254
13702,0,0,42,0,-42
13703,1,1,203,2185,1982
13704,0,0,11,0,-11
13705,1,0,6,0,-6
13706,1,1,1137,1354,217
13707,1,1,1069,1748,679
13708,0,0,18,0,-18
13709,0,0,36,0,-36
13710,1,1,332,1441,1109
13711,1,0,57,0,-57
13712,0,0,93,0,-93
13713,1,0,69,0,-69
13714,0,0,28,0,-28
13715,1,0,174,0,-174
13716,1,1,64,1224,1160
13717,1,1,909,1615,706
13718,1,0,59,0,-59
13719,1,0,105,0,-105
13720,1,1,559,1461,902
13721,1,1,245,1528,1283
13722,1,0,9,0,-9
13723,0,0,28,0,-28
13724,1,1,20,1200,1180
13725,1,0,80,0,-80
13726,1,0,29,0,-29
13727,1,0,43,0,-43
13728,0,0,47,0,-47
13729,0,0,148,0,-148
13730,0,0,20,0,-20
13731,1,1,349,1234,885
13732,1,1,421,4322,3901
13733,0,0,153,0,-153
13734,0,0,38,0,-38
13735,1,0,9,0,-9
13736,1,1,226,1436,1210
13737,1,1,104,1574,1470
13738,1,0,140,0,-140
13739,1,1,582,1249,667
13740,1,0,71,0,-71
13741,1,1,431,1422,991
13742,1,0,48,0,-48
13743,1,1,540,1484,944
13744,0,0,68,0,-68
13745,0,0,50,0,-50
13746,1,0,12,0,-12
13747,1,0,90,0,-90
13748,0,0,15,0,-15
13749,1,1,304,3622,3318
13750,1,0,56,0,-56
13751,1,1,229,1649,1420
13752,0,0,48,0,-48
13753,1,1,453,2092,1639
13754,1,1,523,1522,999
13755,1,0,25,0,-25
13756,0,0,3,0,-3
13757,1,0,36,0,-36
13758,1,1,118,3234,3116
13759,0,0,11,0,-11
13760,1,1,515,1470,955
13761,1,1,469,1247,778
13762,1,0,51,0,-51
13763,1,1,653,1773,1120
13764,0,0,4,0,-4
13765,1,0,56,0,-56
13766,1,1,394,2307,1913
13767,0,0,43,0,-43
13768,1,0,117,0,-117
13769,0,0,22,0,-22
13770,0,0,71,0,-71
13771,0,0,116,0,-116
13772,0,0,23,0,-23
13773,0,0,114,0,-114
13774,1,1,528,1443,915
13775,0,0,51,0,-51
13776,1,1,451,1318,867
13777,0,0,180,0,-180
13778,0,0,79,0,-79
13779,1,1,421,1226,805
13780,1,0,74,0,-74
13781,0,0,79,0,-79
13782,0,0,83,0,-83
13783,1,0,11,0,-11
13784,0,0,14,0,-14
13785,1,1,81,1733,1652
13786,0,0,20,0,-20
13787,1,1,981,2528,1547
13788,0,0,73,0,-73
13789,1,0,32,0,-32
13790,1,0,140,0,-140
13791,0,0,2,0,-2
13792,1,0,114,0,-114
13793,0,0,76,0,-76
13794,0,0,8,0,-8
13795,1,1,383,1826,1443
13796,1,0,4,0,-4
13797,1,1,1801,1399,-402
13798,0,0,69,0,-69
13799,0,0,21,0,-21
13800,1,1,563,2625,2062
13801,1,0,18,0,-18
13802,1,0,20,0,-20
13803,1,0,14,0,-14
13804,1,1,92,1997,1905
13805,0,0,8,0,-8
13806,0,0,41,0,-41
13807,1,0,94,0,-94
13808,0,0,63,0,-63
13809,1,1,122,1789,1667
13810,0,0,57,0,-57
13811,0,0,8,0,-8
13812,0,0,30,0,-30
13813,1,1,666,2543,1877
13814,0,0,150,0,-150
13815,0,0,60,0,-60
13816,1,0,244,0,-244
13817,1,1,33,1449,1416
13818,0,0,37,0,-37
13819,1,0,23,0,-23
13820,1,0,29,0,-29
13821,1,1,651,1437,786
13822,1,1,217,1226,1009
13823,0,0,299,0,-299
13824,0,0,11,0,-11
13825,1,1,653,2755,2102
13826,1,0,24,0,-24
13827,0,0,18,0,-18
13828,0,0,52,0,-52
13829,1,1,103,1555,1452
13830,0,0,0,0,0
13831,0,0,56,0,-56
13832,1,1,1566,1689,123
13833,0,0,67,0,-67
13834,1,0,70,0,-70
13835,1,1,962,1525,563
13836,1,0,9,0,-9
13837,0,0,107,0,-107
13838,0,0,25,0,-25
13839,1,0,173,0,-173
13840,1,0,6,0,-6
13841,1,1,352,1249,897
13842,0,0,133,0,-133
13843,1,1,1166,1503,337
13844,1,0,86,0,-86
13845,1,1,109,1456,1347
13846,1,1,44,2312,2268
13847,0,0,162,0,-162
13848,1,0,0,0,0
13849,1,1,331,1595,1264
13850,0,0,7,0,-7
13851,1,0,18,0,-18
13852,0,0,42,0,-42
13853,1,1,2419,3045,626
13854,1,1,64,3168,3104
13855,1,0,56,0,-56
13856,1,0,12,0,-12
13857,0,0,42,0,-42
13858,1,1,507,1302,795
13859,0,0,122,0,-122
13860,0,0,25,0,-25
13861,0,0,91,0,-91
13862,1,0,66,0,-66
13863,1,1,32,1735,1703
13864,0,0,192,0,-192
13865,0,0,28,0,-28
13866,0,0,9,0,-9
13867,1,1,426,2617,2191
13868,1,1,338,1343,1005
13869,0,0,240,0,-240
13870,1,1,2129,1273,-856
13871,1,0,3,0,-3
13872,0,0,103,0,-103
13873,1,0,98,0,-98
13874,0,0,6,0,-6
13875,0,0,26,0,-26
13876,1,1,60,2465,2405
13877,1,1,1480,1303,-177
13878,1,0,55,0,-55
13879,0,0,37,0,-37
13880,1,0,65,0,-65
13881,0,0,53,0,-53
13882,1,1,39,1689,1650
13883,1,0,10,0,-10
13884,0,0,13,0,-13
13885,1,1,221,1356,1135
13886,0,0,24,0,-24
13887,1,1,251,1252,1001
13888,0,0,47,0,-47
13889,1,0,46,0,-46
13890,1,0,30,0,-30
13891,1,0,30,0,-30
13892,1,1,963,1556,593
13893,0,0,15,0,-15
13894,0,0,127,0,-127
13895,0,0,36,0,-36
13896,1,1,1152,1473,321
13897,1,0,104,0,-104
13898,1,1,110,1357,1247
13899,1,1,430,1937,1507
13900,0,0,2,0,-2
13901,1,0,63,0,-63
13902,0,0,30,0,-30
13903,1,0,74,0,-74
13904,0,0,49,0,-49
13905,0,0,37,0,-37
13906,1,0,78,0,-78
13907,1,0,33,0,-33
13908,1,1,472,1987,1515
13909,1,1,86,1205,1119
13910,0,0,3,0,-3
13911,0,0,3,0,-3
13912,1,1,567,1212,645
13913,1,0,61,0,-61
13914,1,1,532,2336,1804
13915,1,1,326,1662,1336
13916,1,0,43,0,-43
13917,0,0,281,0,-281
13918,1,1,472,1445,973
13919,1,0,19,0,-19
13920,0,0,29,0,-29
13921,0,0,50,0,-50
13922,1,1,261,1206,945
13923,0,0,31,0,-31
13924,1,0,220,0,-220
13925,0,0,44,0,-44
13926,1,0,18,0,-18
13927,0,0,30,0,-30
13928,0,0,122,0,-122
13929,1,1,1043,1207,164
13930,0,0,21,0,-21
13931,0,0,10,0,-10
13932,1,0,29,0,-29
13933,1,1,623,2245,1622
13934,1,0,3,0,-3
13935,1,1,17,1211,1194
13936,1,0,21,0,-21
13937,1,1,409,1417,1008
13938,0,0,141,0,-141
13939,1,1,125,1361,1236
13940,0,0,1,0,-1
13941,0,0,10,0,-10
13942,0,0,9,0,-9
13943,1,1,1142,1292,150
13944,1,0,17,0,-17
13945,0,0,16,0,-16
13946,0,0,38,0,-38
13947,0,0,1,0,-1
13948,0,0,20,0,-20
13949,1,0,40,0,-40
13950,0,0,13,0,-13
13951,0,0,39,0,-39
13952,1,1,918,1272,354
13953,1,1,2652,1324,-1328
13954,0,0,0,0,0
13955,1,0,20,0,-20
13956,1,1,460,1205,745
13957,0,0,47,0,-47
13958,0,0,48,0,-48
13959,1,1,488,3132,2644
13960,1,0,25,0,-25
13961,0,0,41,0,-41
13962,1,0,51,0,-51
13963,0,0,36,0,-36
13964,1,1,83,2321,2238
13965,1,0,21,0,-21
13966,1,0,13,0,-13
13967,1,0,7,0,-7
13968,0,0,18,0,-18
13969,0,0,63,0,-63
13970,1,0,29,0,-29
13971,0,0,32,0,-32
13972,0,0,17,0,-17
13973,1,1,168,1384,1216
13974,1,0,32,0,-32
13975,0,0,21,0,-21
13976,0,0,44,0,-44
13977,0,0,107,0,-107
13978,1,0,10,0,-10
13979,0,0,112,0,-112
13980,1,0,7,0,-7
13981,1,1,487,1466,979
13982,1,0,47,0,-47
13983,0,0,141,0,-141
13984,1,1,226,1260,1034
13985,1,0,18,0,-18
13986,1,0,30,0,-30
13987,0,0,76,0,-76
13988,1,1,1049,1873,824
13989,1,0,24,0,-24
13990,0,0,119,0,-119
13991,0,0,76,0,-76
13992,1,0,42,0,-42
13993,0,0,36,0,-36
13994,1,0,13,0,-13
13995,1,1,656,1348,692
13996,1,1,29,1347,1318
13997,0,0,27,0,-27
13998,1,1,131,1202,1071
13999,1,1,154,1362,1208
14000,1,0,129,0,-129
14001,0,0,37,0,-37
14002,1,0,19,0,-19
14003,0,0,0,0,0
14004,1,1,271,1230,959
14005,0,0,67,0,-67
14006,1,0,24,0,-24
14007,1,1,97,1445,1348
14008,0,0,31,0,-31
14009,1,1,509,1459,950
14010,1,1,743,1764,1021
14011,1,0,47,0,-47
14012,1,1,320,1997,1677
14013,1,0,123,0,-123
14014,1,0,30,0,-30
14015,0,0,17,0,-17
14016,0,0,161,0,-161
14017,1,1,981,1297,316
14018,0,0,19,0,-19
14019,1,1,322,1379,1057
14020,1,0,22,0,-22
14021,1,0,2,0,-2
14022,1,1,531,1609,1078
14023,1,1,117,1287,1170
14024,0,0,54,0,-54
14025,1,1,543,2047,1504
14026,1,0,43,0,-43
14027,1,0,90,0,-90
14028,1,1,280,1751,1471
14029,1,0,37,0,-37
14030,1,0,13,0,-13
14031,0,0,73,0,-73
14032,1,1,989,1356,367
14033,1,0,73,0,-73
14034,0,0,20,0,-20
14035,0,0,7,0,-7
14036,1,1,162,1226,1064
14037,1,0,83,0,-83
14038,0,0,19,0,-19
14039,1,0,56,0,-56
14040,0,0,69,0,-69
14041,1,1,1453,4086,2633
14042,1,0,34,0,-34
14043,1,0,39,0,-39
14044,0,0,12,0,-12
14045,1,1,732,1314,582
14046,0,0,12,0,-12
14047,1,1,970,1236,266
14048,1,0,32,0,-32
14049,0,0,5,0,-5
14050,1,1,122,3735,3613
14051,0,0,76,0,-76
14052,1,1,135,2819,2684
14053,1,0,119,0,-119
14054,0,0,7,0,-7
14055,0,0,13,0,-13
14056,1,0,13,0,-13
14057,1,0,6,0,-6
14058,1,0,17,0,-17
14059,0,0,15,0,-15
14060,1,1,1516,1449,-67
14061,0,0,96,0,-96
14062,1,0,70,0,-70
14063,1,0,5,0,-5
14064,1,1,481,1500,1019
14065,1,0,38,0,-38
14066,0,0,5,0,-5
14067,0,0,248,0,-248
14068,0,0,1,0,-1
14069,0,0,0,0,0
14070,1,0,151,0,-151
14071,1,1,545,1445,900
14072,1,0,92,0,-92
14073,1,0,35,0,-35
14074,0,0,27,0,-27
14075,1,0,63,0,-63
14076,0,0,0,0,0
14077,0,0,94,0,-94
14078,0,0,8,0,-8
14079,1,1,1782,1269,-513
14080,1,0,21,0,-21
14081,0,0,20,0,-20
14082,0,0,97,0,-97
14083,1,0,2,0,-2
14084,1,1,897,1790,893
14085,0,0,44,0,-44
14086,1,1,68,1282,1214
14087,0,0,11,0,-11
14088,0,0,61,0,-61
14089,1,1,470,1381,911
14090,1,1,1181,1222,41
14091,1,0,0,0,0
14092,1,0,39,0,-39
14093,1,1,157,2201,2044
14094,0,0,23,0,-23
14095,1,0,6,0,-6
14096,0,0,34,0,-34
14097,0,0,23,0,-23
14098,1,0,8,0,-8
14099,1,0,4,0,-4
14100,1,0,41,0,-41
14101,0,0,46,0,-46
14102,1,1,258,1245,987
14103,1,1,242,1788,1546
14104,1,0,173,0,-173
14105,0,0,21,0,-21
14106,1,1,409,1584,1175
14107,1,1,200,1378,1178
14108,1,1,69,1264,1195
14109,1,0,108,0,-108
14110,0,0,13,0,-13
14111,0,0,8,0,-8
14112,1,1,919,1569,650
14113,1,0,120,0,-120
14114,1,1,175,1529,1354
14115,0,0,23,0,-23
14116,1,1,207,2194,1987
14117,0,0,8,0,-8
14118,0,0,22,0,-22
14119,1,1,651,1304,653
14120,1,1,143,1436,1293
14121,1,1,320,1343,1023
14122,0,0,14,0,-14
14123,0,0,123,0,-123
14124,0,0,18,0,-18
14125,1,0,31,0,-31
14126,1,0,88,0,-88
14127,0,0,8,0,-8
14128,0,0,106,0,-106
14129,1,1,809,1219,410
14130,1,0,4,0,-4
14131,1,0,31,0,-31
14132,1,1,1038,1612,574
14133,0,0,13,0,-13
14134,1,1,925,1283,358
14135,0,0,112,0,-112
14136,1,1,477,1241,764
14137,0,0,3,0,-3
14138,0,0,35,0,-35
14139,0,0,205,0,-205
14140,0,0,5,0,-5
14141,1,1,210,2114,1904
14142,1,0,66,0,-66
14143,1,0,68,0,-68
14144,0,0,26,0,-26
14145,0,0,43,0,-43
14146,0,0,10,0,-10
14147,1,0,174,0,-174
14148,1,0,52,0,-52
14149,0,0,34,0,-34
14150,0,0,78,0,-78
14151,1,0,3,0,-3
14152,1,1,170,1993,1823
14153,0,0,7,0,-7
14154,1,0,47,0,-47
14155,1,1,351,1689,1338
14156,0,0,6,0,-6
14157,1,0,84,0,-84
14158,0,0,69,0,-69
14159,0,0,28,0,-28
14160,1,1,185,1218,1033
14161,1,0,6,0,-6
14162,0,0,46,0,-46
14163,1,0,85,0,-85
14164,0,0,50,0,-50
14165,1,1,352,1527,1175
14166,0,0,31,0,-31
14167,1,1,965,1385,420
14168,1,0,34,0,-34
14169,1,0,60,0,-60
14170,1,0,121,0,-121
14171,1,1,1212,2197,985
14172,0,0,36,0,-36
14173,1,1,904,2425,1521
14174,0,0,0,0,0
14175,1,1,787,1301,514
14176,1,0,191,0,-191
14177,0,0,15,0,-15
14178,1,1,59,1328,1269
14179,1,1,78,1515,1437
14180,0,0,12,0,-12
14181,1,1,80,1598,1518
14182,1,0,31,0,-31
14183,1,1,994,2906,1912
14184,0,0,43,0,-43
14185,1,0,4,0,-4
14186,0,0,8,0,-8
14187,1,1,925,2106,1181
14188,0,0,2,0,-2
14189,1,0,92,0,-92
14190,1,0,84,0,-84
14191,0,0,28,0,-28
14192,1,1,63,1669,1606
14193,0,0,29,0,-29
14194,0,0,158,0,-158
14195,0,0,5,0,-5
14196,1,1,52,1399,1347
14197,0,0,137,0,-137
14198,1,0,41,0,-41
14199,1,0,94,0,-94
14200,0,0,46,0,-46
14201,1,0,47,0,-47
14202,1,1,553,1279,726
14203,1,1,289,1509,1220
14204,0,0,40,0,-40
14205,1,0,20,0,-20
14206,1,1,975,1239,264
14207,1,0,82,0,-82
14208,1,0,11,0,-11
14209,0,0,7,0,-7
14210,1,1,936,1669,733
14211,0,0,2,0,-2
14212,0,0,77,0,-77
14213,1,0,35,0,-35
14214,1,1,248,1637,1389
14215,0,0,63,0,-63
14216,0,0,64,0,-64
14217,1,0,58,0,-58
14218,0,0,3,0,-3
14219,1,1,62,3239,3177
14220,0,0,20,0,-20
14221,1,0,85,0,-85
14222,0,0,3,0,-3
14223,1,0,21,0,-21
14224,0,0,2,0,-2
14225,1,1,156,1346,1190
14226,0,0,7,0,-7
14227,0,0,76,0,-76
14228,0,0,8,0,-8
14229,0,0,20,0,-20
14230,0,0,8,0,-8
14231,0,0,107,0,-107
14232,1,0,2,0,-2
14233,1,1,241,1541,1300
14234,1,1,97,1808,1711
14235,1,0,90,0,-90
14236,1,1,103,1793,1690
14237,1,0,53,0,-53
14238,1,0,70,0,-70
14239,1,1,361,1719,1358
14240,1,0,13,0,-13
14241,0,0,43,0,-43
14242,0,0,52,0,-52
14243,0,0,24,0,-24
14244,1,1,1171,2856,1685
14245,1,0,22,0,-22
14246,1,1,1401,1673,272
14247,1,1,1559,1219,-340
14248,0,0,0,0,0
14249,1,0,73,0,-73
14250,0,0,62,0,-62
14251,0,0,45,0,-45
14252,0,0,24,0,-24
14253,1,1,749,1563,814
14254,0,0,164,0,-164
14255,1,0,103,0,-103
14256,1,0,66,0,-66
14257,1,0,20,0,-20
14258,0,0,8,0,-8
14259,0,0,99,0,-99
14260,1,1,309,1331,1022
14261,1,1,90,1291,1201
14262,1,1,258,1209,951
14263,1,1,44,1426,1382
14264,1,0,14,0,-14
14265,1,0,114,0,-114
14266,1,0,16,0,-16
14267,1,1,716,1213,497
14268,1,1,1088,1417,329
14269,1,0,13,0,-13
14270,0,0,18,0,-18
14271,1,0,16,0,-16
14272,1,1,119,1401,1282
14273,1,0,93,0,-93
14274,1,1,226,1343,1117
14275,1,1,81,1428,1347
14276,1,1,1026,1426,400
14277,0,0,14,0,-14
14278,1,0,39,0,-39
14279,0,0,102,0,-102
14280,0,0,45,0,-45
14281,1,0,40,0,-40
14282,0,0,78,0,-78
14283,0,0,7,0,-7
14284,1,1,1364,1549,185
14285,1,0,25,0,-25
14286,1,0,1,0,-1
14287,0,0,17,0,-17
14288,0,0,49,0,-49
14289,1,0,16,0,-16
14290,0,0,7,0,-7
14291,0,0,4,0,-4
14292,1,1,420,1367,947
14293,0,0,67,0,-67
14294,1,0,20,0,-20
14295,1,0,79,0,-79
14296,0,0,63,0,-63
14297,1,0,79,0,-79
14298,0,0,17,0,-17
14299,1,1,875,2293,1418
14300,1,0,31,0,-31
14301,1,0,97,0,-97
14302,0,0,55,0,-55
14303,1,0,19,0,-19
14304,1,0,50,0,-50
14305,0,0,10,0,-10
14306,1,1,436,1272,836
14307,1,0,33,0,-33
14308,1,1,470,1343,873
14309,1,0,86,0,-86
14310,0,0,45,0,-45
14311,1,0,154,0,-154
14312,1,1,69,1628,1559
14313,1,0,21,0,-21
14314,1,0,90,0,-90
14315,0,0,21,0,-21
14316,1,1,2868,1288,-1580
14317,0,0,30,0,-30
14318,1,1,168,1506,1338
14319,1,1,282,3622,3340
14320,0,0,31,0,-31
14321,0,0,25,0,-25
14322,1,1,160,1264,1104
14323,0,0,43,0,-43
14324,1,1,394,1205,811
14325,1,1,606,1284,678
14326,1,0,41,0,-41
14327,0,0,22,0,-22
14328,1,0,32,0,-32
14329,0,0,117,0,-117
14330,0,0,7,0,-7
14331,0,0,7,0,-7
14332,0,0,34,0,-34
14333,1,0,17,0,-17
14334,1,1,40,1381,1341
14335,0,0,1,0,-1
14336,0,0,45,0,-45
14337,0,0,72,0,-72
14338,1,1,485,1527,1042
14339,1,0,248,0,-248
14340,0,0,74,0,-74
14341,0,0,73,0,-73
14342,1,1,251,1291,1040
14343,0,0,5,0,-5
14344,0,0,42,0,-42
14345,0,0,92,0,-92
14346,1,0,20,0,-20
14347,1,0,61,0,-61
14348,0,0,15,0,-15
14349,1,1,1473,1273,-200
14350,0,0,64,0,-64
14351,1,1,356,1593,1237
14352,1,0,23,0,-23
14353,1,1,1027,1237,210
14354,1,1,125,1570,1445
14355,0,0,3,0,-3
14356,0,0,156,0,-156
14357,0,0,68,0,-68
14358,1,1,1084,1230,146
14359,0,0,15,0,-15
14360,1,1,311,1306,995
14361,1,1,239,1472,1233
14362,1,0,2,0,-2
14363,1,1,254,1334,1080
14364,1,0,48,0,-48
14365,1,0,204,0,-204
14366,1,0,7,0,-7
14367,0,0,12,0,-12
14368,1,1,90,1205,1115
14369,0,0,92,0,-92
14370,1,1,887,1270,383
14371,0,0,16,0,-16
14372,1,0,9,0,-9
14373,1,1,813,2042,1229
14374,0,0,21,0,-21
14375,1,0,8,0,-8
14376,1,1,214,1392,1178
14377,1,1,474,1267,793
14378,1,1,1272,2051,779
14379,1,0,40,0,-40
14380,1,0,14,0,-14
14381,1,1,499,1394,895
14382,1,0,4,0,-4
14383,1,1,269,1766,1497
14384,1,1,585,2065,1480
14385,1,0,29,0,-29
14386,0,0,107,0,-107
14387,1,0,4,0,-4
14388,0,0,42,0,-42
14389,1,1,258,1517,1259
14390,1,1,92,1275,1183
14391,0,0,135,0,-135
14392,0,0,94,0,-94
14393,1,0,87,0,-87
14394,0,0,18,0,-18
14395,0,0,74,0,-74
14396,0,0,1,0,-1
14397,1,1,100,1727,1627
14398,1,0,4,0,-4
14399,1,1,386,1251,865
14400,1,1,490,1239,749
14401,0,0,41,0,-41
14402,0,0,2,0,-2
14403,0,0,54,0,-54
14404,0,0,37,0,-37
14405,0,0,42,0,-42
14406,1,1,388,1366,978
14407,1,1,732,1577,845
14408,0,0,19,0,-19
14409,1,1,830,1410,580
14410,1,1,604,1516,912
14411,0,0,91,0,-91
14412,1,1,1005,1234,229
14413,0,0,30,0,-30
14414,1,0,36,0,-36
14415,1,1,1797,1202,-595
14416,1,0,36,0,-36
14417,1,0,9,0,-9
14418,0,0,90,0,-90
14419,0,0,26,0,-26
14420,1,0,1,0,-1
14421,0,0,33,0,-33
14422,0,0,135,0,-135
14423,1,0,40,0,-40
14424,1,0,48,0,-48
14425,0,0,23,0,-23
14426,0,0,158,0,-158
14427,1,1,53,1232,1179
14428,1,0,22,0,-22
14429,0,0,29,0,-29
14430,1,0,31,0,-31
14431,0,0,2,0,-2
14432,0,0,2,0,-2
14433,1,0,27,0,-27
14434,1,0,37,0,-37
14435,1,0,138,0,-138
14436,1,0,51,0,-51
14437,1,1,393,1278,885
14438,0,0,105,0,-105
14439,0,0,49,0,-49
14440,1,1,319,1406,1087
14441,0,0,6,0,-6
14442,0,0,14,0,-14
14443,0,0,136,0,-136
14444,1,1,1106,1281,175
14445,1,0,4,0,-4
14446,1,0,53,0,-53
14447,1,0,7,0,-7
14448,0,0,40,0,-40
14449,1,1,672,2079,1407
14450,0,0,79,0,-79
14451,1,1,37,1382,1345
14452,0,0,49,0,-49
14453,1,0,46,0,-46
14454,0,0,4,0,-4
14455,1,0,52,0,-52
14456,0,0,38,0,-38
14457,0,0,128,0,-128
14458,1,0,1,0,-1
14459,1,1,404,1318,914
14460,1,0,84,0,-84
14461,1,1,817,1303,486
14462,1,1,83,1250,1167
14463,1,0,6,0,-6
14464,0,0,8,0,-8
14465,1,1,267,1518,1251
14466,0,0,28,0,-28
14467,0,0,6,0,-6
14468,0,0,18,0,-18
14469,0,0,119,0,-119
14470,1,1,743,1437,694
14471,0,0,133,0,-133
14472,1,0,27,0,-27
14473,1,0,38,0,-38
14474,1,1,1245,1324,79
14475,0,0,13,0,-13
14476,0,0,53,0,-53
14477,1,0,3,0,-3
14478,0,0,9,0,-9
14479,1,1,71,1327,1256
14480,1,1,1551,1232,-319
14481,1,1,631,1551,920
14482,0,0,24,0,-24
14483,0,0,6,0,-6
14484,1,0,17,0,-17
14485,1,1,1585,1236,-349
14486,1,0,60,0,-60
14487,0,0,4,0,-4
14488,1,0,19,0,-19
14489,0,0,9,0,-9
14490,1,0,22,0,-22
14491,0,0,16,0,-16
14492,1,1,88,1209,1121
14493,0,0,122,0,-122
14494,1,1,263,1310,1047
14495,1,0,7,0,-7
14496,1,1,62,1727,1665
14497,1,1,825,1408,583
14498,0,0,111,0,-111
14499,1,0,64,0,-64
14500,0,0,7,0,-7
14501,0,0,2,0,-2
14502,0,0,29,0,-29
14503,1,1,461,1223,762
14504,1,1,255,1316,1061
14505,0,0,6,0,-6
14506,0,0,37,0,-37
14507,1,1,250,1710,1460
14508,1,0,22,0,-22
14509,0,0,125,0,-125
14510,0,0,25,0,-25
14511,1,1,675,1361,686
14512,0,0,20,0,-20
14513,0,0,47,0,-47
14514,1,0,29,0,-29
14515,1,1,223,1240,1017
14516,1,1,89,2154,2065
14517,1,0,10,0,-10
14518,1,1,279,1770,1491
14519,1,0,105,0,-105
14520,0,0,25,0,-25
14521,1,0,48,0,-48
14522,1,0,22,0,-22
14523,1,1,765,1319,554
14524,0,0,76,0,-76
14525,1,0,37,0,-37
14526,1,1,920,1314,394
14527,1,0,14,0,-14
14528,1,1,125,2465,2340
14529,0,0,100,0,-100
14530,1,1,845,1798,953
14531,1,1,25,2570,2545
14532,1,0,101,0,-101
14533,1,1,803,1752,949
14534,1,0,1,0,-1
14535,0,0,159,0,-159
14536,1,1,380,1589,1209
14537,1,1,238,1878,1640
14538,1,1,73,1634,1561
14539,1,1,550,1224,674
14540,1,0,20,0,-20
14541,1,0,41,0,-41
14542,0,0,93,0,-93
14543,1,1,187,1232,1045
14544,0,0,158,0,-158
14545,1,0,54,0,-54
14546,1,1,142,1658,1516
14547,0,0,2,0,-2
14548,1,1,108,2200,2092
14549,1,1,858,1805,947
14550,1,0,69,0,-69
14551,0,0,93,0,-93
14552,0,0,142,0,-142
14553,1,1,234,1293,1059
14554,1,0,16,0,-16
14555,1,0,106,0,-106
14556,1,1,842,2165,1323
14557,1,0,80,0,-80
14558,1,0,18,0,-18
14559,1,0,140,0,-140
14560,1,1,354,1442,1088
14561,0,0,96,0,-96
14562,1,0,99,0,-99
14563,1,1,1158,1205,47
14564,0,0,16,0,-16
14565,1,1,132,1347,1215
14566,0,0,22,0,-22
14567,1,1,663,1227,564
14568,1,0,117,0,-117
14569,1,1,921,1215,294
14570,1,0,68,0,-68
14571,0,0,1,0,-1
14572,1,0,4,0,-4
14573,0,0,1,0,-1
14574,1,0,39,0,-39
14575,1,0,310,0,-310
14576,0,0,44,0,-44
14577,1,1,114,1829,1715
14578,1,0,48,0,-48
14579,0,0,51,0,-51
14580,1,1,23,1807,1784
14581,0,0,11,0,-11
14582,1,1,192,1762,1570
14583,1,1,413,1214,801
14584,1,1,30,1363,1333
14585,1,1,1423,1304,-119
14586,0,0,177,0,-177
14587,1,0,76,0,-76
14588,1,1,1962,1244,-718
14589,1,1,210,2053,1843
14590,1,0,117,0,-117
14591,1,1,110,1210,1100
14592,0,0,13,0,-13
14593,1,0,6,0,-6
14594,1,1,411,1898,1487
14595,1,0,12,0,-12
14596,1,0,95,0,-95
14597,0,0,19,0,-19
14598,0,0,1,0,-1
14599,1,0,86,0,-86
14600,1,1,1058,2748,1690
14601,1,0,107,0,-107
14602,1,0,14,0,-14
14603,1,0,26,0,-26
14604,0,0,15,0,-15
14605,1,0,13,0,-13
14606,1,0,141,0,-141
14607,1,0,45,0,-45
14608,0,0,22,0,-22
14609,1,1,1322,1301,-21
14610,0,0,40,0,-40
14611,1,1,156,1660,1504
14612,0,0,19,0,-19
14613,1,1,543,1525,982
14614,0,0,38,0,-38
14615,0,0,22,0,-22
14616,1,1,33,1533,1500
14617,1,1,438,1374,936
14618,0,0,3,0,-3
14619,0,0,154,0,-154
14620,1,0,3,0,-3
14621,1,0,77,0,-77
14622,1,1,100,1422,1322
14623,1,1,207,1773,1566
14624,1,1,875,1422,547
14625,0,0,230,0,-230
14626,0,0,34,0,-34
14627,0,0,52,0,-52
14628,1,1,97,1645,1548
14629,0,0,64,0,-64
14630,1,1,388,1224,836
14631,0,0,120,0,-120
14632,0,0,7,0,-7
14633,0,0,70,0,-70
14634,1,0,14,0,-14
14635,0,0,59,0,-59
14636,1,0,0,0,0
14637,0,0,167,0,-167
14638,1,1,1107,1307,200
14639,1,1,123,1801,1678
14640,0,0,60,0,-60
14641,1,1,54,1348,1294
14642,1,0,75,0,-75
14643,1,0,14,0,-14
14644,1,1,1019,1670,651
14645,1,0,17,0,-17
14646,0,0,16,0,-16
14647,1,1,216,1256,1040
14648,0,0,14,0,-14
14649,1,1,483,1330,847
14650,0,0,13,0,-13
14651,1,0,100,0,-100
14652,0,0,1,0,-1
14653,0,0,72,0,-72
14654,0,0,3,0,-3
14655,1,1,489,1296,807
14656,1,0,39,0,-39
14657,1,1,257,1668,1411
14658,1,0,15,0,-15
14659,1,0,8,0,-8
14660,1,0,88,0,-88
14661,0,0,22,0,-22
14662,1,1,199,1419,1220
14663,1,1,397,1706,1309
14664,0,0,2,0,-2
14665,1,0,23,0,-23
14666,0,0,68,0,-68
14667,1,1,203,1390,1187
14668,1,0,16,0,-16
14669,1,0,36,0,-36
14670,1,1,156,1945,1789
14671,0,0,172,0,-172
14672,1,1,162,2582,2420
14673,1,1,406,1265,859
14674,1,1,97,1314,1217
14675,1,1,237,1700,1463
14676,1,1,88,1856,1768
14677,0,0,51,0,-51
14678,0,0,115,0,-115
14679,1,1,935,1223,288
14680,1,1,399,1428,1029
14681,1,0,51,0,-51
14682,1,1,165,1576,1411
14683,1,0,5,0,-5
14684,0,0,29,0,-29
14685,1,1,616,1372,756
14686,1,1,278,1245,967
14687,1,1,296,1244,948
14688,1,1,324,1318,994
14689,1,0,70,0,-70
14690,1,0,17,0,-17
14691,1,0,33,0,-33
14692,0,0,40,0,-40
14693,1,1,1037,1507,470
14694,1,0,51,0,-51
14695,0,0,106,0,-106
14696,1,0,32,0,-32
14697,1,1,398,1201,803
14698,1,0,54,0,-54
14699,1,1,703,1477,774
14700,0,0,21,0,-21
14701,1,1,109,1720,1611
14702,1,1,399,1525,1126
14703,0,0,45,0,-45
14704,0,0,14,0,-14
14705,1,1,595,1482,887
14706,1,1,137,1509,1372
14707,0,0,65,0,-65
14708,1,1,1210,1256,46
14709,0,0,72,0,-72
14710,1,1,49,1784,1735
14711,0,0,23,0,-23
14712,0,0,1,0,-1
14713,1,1,156,1603,1447
14714,0,0,68,0,-68
14715,0,0,12,0,-12
14716,0,0,22,0,-22
14717,1,0,26,0,-26
14718,1,0,68,0,-68
14719,0,0,100,0,-100
14720,1,1,811,1517,706
14721,1,1,436,4215,3779
14722,0,0,7,0,-7
14723,1,1,245,1225,980
14724,0,0,2,0,-2
14725,1,1,224,1958,1734
14726,1,0,31,0,-31
14727,1,1,839,1700,861
14728,0,0,98,0,-98
14729,1,1,258,1515,1257
14730,1,1,1691,1217,-474
14731,0,0,47,0,-47
14732,0,0,1,0,-1
14733,1,0,49,0,-49
14734,1,1,888,1205,317
14735,1,0,13,0,-13
14736,1,1,434,1225,791
14737,1,0,17,0,-17
14738,0,0,3,0,-3
14739,1,1,79,3897,3818
14740,0,0,2,0,-2
14741,0,0,20,0,-20
14742,1,1,66,1274,1208
14743,1,1,261,1637,1376
14744,1,0,28,0,-28
14745,0,0,29,0,-29
14746,0,0,4,0,-4
14747,1,0,38,0,-38
14748,0,0,91,0,-91
14749,0,0,15,0,-15
14750,1,1,116,1332,1216
14751,0,0,36,0,-36
14752,1,0,12,0,-12
14753,1,1,514,1279,765
14754,0,0,23,0,-23
14755,1,0,22,0,-22
14756,1,1,315,1362,1047
14757,1,1,254,1209,955
14758,1,0,82,0,-82
14759,1,0,24,0,-24
14760,1,1,113,1364,1251
14761,1,1,1395,1236,-159
14762,1,1,448,1302,854
14763,1,0,19,0,-19
14764,1,1,212,1741,1529
14765,1,1,216,1279,1063
14766,0,0,17,0,-17
14767,1,0,29,0,-29
14768,0,0,73,0,-73
14769,1,0,9,0,-9
14770,1,1,155,1784,1629
14771,0,0,6,0,-6
14772,0,0,10,0,-10
14773,0,0,14,0,-14
14774,1,1,594,1324,730
14775,0,0,12,0,-12
14776,0,0,14,0,-14
14777,1,1,367,1972,1605
14778,0,0,193,0,-193
14779,1,1,185,1695,1510
14780,1,0,26,0,-26
14781,0,0,43,0,-43
14782,1,0,3,0,-3
14783,0,0,35,0,-35
14784,1,1,271,1344,1073
14785,0,0,33,0,-33
14786,1,1,249,1257,1008
14787,0,0,14,0,-14
14788,1,1,261,1548,1287
14789,1,1,434,1830,1396
14790,1,0,22,0,-22
14791,1,0,127,0,-127
14792,1,0,16,0,-16
14793,1,0,61,0,-61
14794,1,1,396,1639,1243
14795,1,1,130,1438,1308
14796,0,0,20,0,-20
14797,0,0,99,0,-99
14798,1,1,1057,1400,343
14799,0,0,46,0,-46
14800,1,0,72,0,-72
14801,0,0,90,0,-90
14802,1,0,127,0,-127
14803,0,0,95,0,-95
14804,1,1,781,1259,478
14805,0,0,3,0,-3
14806,0,0,14,0,-14
14807,0,0,140,0,-140
14808,1,0,77,0,-77
14809,1,0,40,0,-40
14810,1,1,1086,3522,2436
14811,1,0,72,0,-72
14812,0,0,3,0,-3
14813,0,0,17,0,-17
14814,1,0,4,0,-4
14815,0,0,154,0,-154
14816,1,0,8,0,-8
14817,0,0,118,0,-118
14818,0,0,30,0,-30
14819,1,1,95,1487,1392
14820,0,0,84,0,-84
14821,1,1,502,1281,779
14822,1,1,199,2721,2522
14823,0,0,18,0,-18
14824,1,0,10,0,-10
14825,0,0,50,0,-50
14826,0,0,58,0,-58
14827,1,1,1197,1575,378
14828,1,1,735,1936,1201
14829,1,1,743,1319,576
14830,1,0,97,0,-97
14831,0,0,26,0,-26
14832,1,1,507,1717,1210
14833,0,0,19,0,-19
14834,1,0,12,0,-12
14835,0,0,13,0,-13
14836,0,0,13,0,-13
14837,0,0,18,0,-18
14838,1,0,6,0,-6
14839,1,0,30,0,-30
14840,0,0,26,0,-26
14841,1,1,533,1414,881
14842,0,0,87,0,-87
14843,1,0,14,0,-14
14844,1,0,58,0,-58
14845,1,0,22,0,-22
14846,1,1,99,1230,1131
14847,0,0,37,0,-37
14848,1,1,592,3293,2701
14849,1,1,153,1886,1733
14850,1,0,96,0,-96
14851,1,1,311,1354,1043
14852,0,0,8,0,-8
14853,0,0,0,0,0
14854,1,0,25,0,-25
14855,1,1,970,1298,328
14856,1,1,40,1521,1481
14857,1,1,1446,1355,-91
14858,1,1,728,1447,719
14859,0,0,13,0,-13
14860,0,0,187,0,-187
14861,0,0,13,0,-13
14862,1,0,16,0,-16
14863,1,0,18,0,-18
14864,1,0,102,0,-102
14865,1,0,57,0,-57
14866,1,0,29,0,-29
14867,1,0,23,0,-23
14868,0,0,9,0,-9
14869,1,0,8,0,-8
14870,1,1,1374,1278,-96
14871,1,1,805,1357,552
14872,1,1,867,1399,532
14873,1,1,2939,1398,-1541
14874,1,1,60,1343,1283
14875,1,0,39,0,-39
14876,0,0,79,0,-79
14877,1,1,1018,1695,677
14878,1,1,389,2323,1934
14879,1,0,36,0,-36
14880,0,0,67,0,-67
14881,0,0,48,0,-48
14882,0,0,16,0,-16
14883,1,0,72,0,-72
14884,0,0,184,0,-184
14885,1,0,15,0,-15
14886,0,0,12,0,-12
14887,1,0,4,0,-4
14888,0,0,179,0,-179
14889,0,0,34,0,-34
14890,0,0,0,0,0
14891,1,0,163,0,-163
14892,1,0,4,0,-4
14893,1,1,536,1273,737
14894,1,0,44,0,-44
14895,1,0,14,0,-14
14896,1,0,31,0,-31
14897,0,0,19,0,-19
14898,0,0,124,0,-124
14899,0,0,11,0,-11
14900,1,0,7,0,-7
14901,0,0,29,0,-29
14902,1,1,282,1425,1143
14903,1,1,874,1351,477
14904,0,0,36,0,-36
14905,1,0,4,0,-4
14906,0,0,78,0,-78
14907,1,1,82,1200,1118
14908,0,0,1,0,-1
14909,0,0,128,0,-128
14910,1,1,52,1208,1156
14911,1,0,27,0,-27
14912,1,1,429,2056,1627
14913,0,0,77,0,-77
14914,0,0,152,0,-152
14915,1,0,3,0,-3
14916,0,0,4,0,-4
14917,0,0,66,0,-66
14918,0,0,13,0,-13
14919,1,0,42,0,-42
14920,1,1,97,1429,1332
14921,1,0,111,0,-111
14922,1,0,35,0,-35
14923,1,0,8,0,-8
14924,0,0,42,0,-42
14925,0,0,83,0,-83
14926,1,1,108,1395,1287
14927,1,0,48,0,-48
14928,1,0,36,0,-36
14929,0,0,53,0,-53
14930,1,0,25,0,-25
14931,1,1,1871,1508,-363
14932,1,0,10,0,-10
14933,0,0,33,0,-33
14934,0,0,0,0,0
14935,0,0,29,0,-29
14936,0,0,13,0,-13
14937,1,0,5,0,-5
14938,0,0,85,0,-85
14939,0,0,48,0,-48
14940,0,0,28,0,-28
14941,0,0,112,0,-112
14942,1,0,12,0,-12
14943,1,0,30,0,-30
14944,1,0,8,0,-8
14945,1,0,64,0,-64
14946,0,0,25,0,-25
14947,1,0,71,0,-71
14948,1,0,2,0,-2
14949,1,1,290,1518,1228
14950,0,0,13,0,-13
14951,1,1,64,1384,1320
14952,0,0,3,0,-3
14953,1,1,478,2312,1834
14954,1,0,113,0,-113
14955,1,0,27,0,-27
14956,1,0,84,0,-84
14957,1,1,703,1843,1140
14958,1,0,25,0,-25
14959,1,1,229,1867,1638
14960,1,0,34,0,-34
14961,1,0,78,0,-78
14962,1,1,133,1411,1278
14963,1,1,1433,1437,4
14964,1,0,13,0,-13
14965,1,1,1398,2172,774
14966,0,0,22,0,-22
14967,0,0,35,0,-35
14968,1,1,207,1238,1031
14969,1,0,103,0,-103
14970,0,0,28,0,-28
14971,1,1,124,1306,1182
14972,1,1,669,2138,1469
14973,1,0,76,0,-76
14974,1,1,272,1239,967
14975,1,0,91,0,-91
14976,0,0,6,0,-6
14977,1,0,10,0,-10
14978,0,0,144,0,-144
14979,1,0,6,0,-6
14980,1,1,740,1329,589
14981,1,1,122,1446,1324
14982,1,0,16,0,-16
14983,0,0,24,0,-24
14984,1,1,439,1562,1123
14985,1,0,2,0,-2
14986,0,0,6,0,-6
14987,1,0,10,0,-10
14988,1,0,6,0,-6
14989,1,0,36,0,-36
14990,0,0,35,0,-35
14991,0,0,52,0,-52
14992,0,0,7,0,-7
14993,1,1,152,1472,1320
14994,1,1,1991,1240,-751
14995,1,0,16,0,-16
14996,1,0,80,0,-80
14997,1,0,6,0,-6
14998,1,0,28,0,-28
14999,0,0,2,0,-2
15000,0,0,54,0,-54
15001,1,0,111,0,-111
15002,1,1,397,1422,1025
15003,0,0,56,0,-56
15004,1,1,1019,1665,646
15005,0,0,101,0,-101
15006,0,0,71,0,-71
15007,0,0,266,0,-266
15008,1,1,892,1224,332
15009,0,0,27,0,-27
15010,1,0,116,0,-116
15011,0,0,35,0,-35
15012,1,1,47,1566,1519
15013,1,0,7,0,-7
15014,1,1,126,1233,1107
15015,0,0,129,0,-129
15016,1,1,398,1281,883
15017,0,0,93,0,-93
15018,0,0,74,0,-74
15019,1,1,290,2266,1976
15020,0,0,17,0,-17
15021,1,1,201,2478,2277
15022,1,0,73,0,-73
15023,1,1,805,2587,1782
15024,1,1,78,1798,1720
15025,1,0,69,0,-69
15026,1,0,25,0,-25
15027,1,1,633,1312,679
15028,1,0,4,0,-4
15029,1,0,121,0,-121
15030,0,0,7,0,-7
15031,0,0,30,0,-30
15032,0,0,13,0,-13
15033,1,0,52,0,-52
15034,1,0,90,0,-90
15035,1,1,338,1411,1073
15036,1,0,4,0,-4
15037,1,1,417,1569,1152
15038,1,1,169,1329,1160
15039,1,1,327,1305,978
15040,1,1,490,1294,804
15041,1,1,547,1587,1040
15042,1,0,139,0,-139
15043,1,0,97,0,-97
15044,1,1,475,1337,862
15045,0,0,55,0,-55
15046,0,0,10,0,-10
15047,1,0,7,0,-7
15048,0,0,62,0,-62
15049,1,0,5,0,-5
15050,1,1,499,1233,734
15051,0,0,28,0,-28
15052,0,0,60,0,-60
15053,1,1,564,1544,980
15054,1,1,491,1229,738
15055,1,0,14,0,-14
15056,1,0,52,0,-52
15057,1,0,59,0,-59
15058,0,0,154,0,-154
15059,1,0,97,0,-97
15060,1,0,285,0,-285
15061,1,1,1216,1253,37
15062,1,0,71,0,-71
15063,1,0,39,0,-39
15064,0,0,14,0,-14
15065,1,1,152,3166,3014
15066,0,0,55,0,-55
15067,0,0,54,0,-54
15068,0,0,6,0,-6
15069,0,0,56,0,-56
15070,0,0,56,0,-56
15071,1,1,192,1364,1172
15072,0,0,43,0,-43
15073,0,0,121,0,-121
15074,1,1,605,2383,1778
15075,1,0,94,0,-94
15076,0,0,48,0,-48
15077,1,1,230,1528,1298
15078,1,0,17,0,-17
15079,1,0,15,0,-15
15080,0,0,99,0,-99
15081,1,1,153,1207,1054
15082,0,0,32,0,-32
15083,1,1,234,1332,1098
15084,1,1,559,1644,1085
15085,1,1,208,1904,1696
15086,1,0,23,0,-23
15087,1,1,1465,2323,858
15088,1,1,1252,1345,93
15089,1,0,58,0,-58
15090,1,1,637,1605,968
15091,0,0,71,0,-71
15092,1,1,969,1742,773
15093,0,0,13,0,-13
15094,1,0,100,0,-100
15095,1,0,59,0,-59
15096,0,0,60,0,-60
15097,0,0,59,0,-59
15098,1,1,776,1894,1118
15099,0,0,27,0,-27
15100,1,0,227,0,-227
15101,1,0,41,0,-41
15102,0,0,39,0,-39
15103,0,0,43,0,-43
15104,1,1,483,1245,762
15105,0,0,32,0,-32
15106,1,1,611,1817,1206
15107,1,1,778,1518,740
15108,0,0,19,0,-19
15109,1,1,1366,1476,110
15110,0,0,1,0,-1
15111,1,0,21,0,-21
15112,1,1,450,1258,808
15113,0,0,6,0,-6
15114,0,0,12,0,-12
15115,1,1,673,1203,530
15116,1,0,36,0,-36
15117,1,0,0,0,0
15118,1,1,256,1458,1202
15119,0,0,45,0,-45
15120,0,0,13,0,-13
15121,1,1,218,1380,1162
15122,1,0,32,0,-32
15123,1,1,171,1351,1180
15124,1,1,516,1572,1056
15125,0,0,11,0,-11
15126,1,1,104,2883,2779
15127,1,1,711,1566,855
15128,1,1,225,1217,992
15129,0,0,63,0,-63
15130,0,0,4,0,-4
15131,1,0,46,0,-46
15132,0,0,92,0,-92
15133,1,0,108,0,-108
15134,1,1,37,1343,1306
15135,1,1,839,1253,414
15136,1,0,9,0,-9
15137,1,1,518,1207,689
15138,1,1,358,1352,994
15139,0,0,23,0,-23
15140,1,1,398,1215,817
15141,1,0,5,0,-5
15142,1,1,205,1641,1436
15143,1,1,135,1318,1183
15144,1,1,394,1886,1492
15145,1,1,1261,1246,-15
15146,0,0,34,0,-34
15147,0,0,54,0,-54
15148,0,0,122,0,-122
15149,1,0,67,0,-67
15150,0,0,9,0,-9
15151,1,1,932,1427,495
15152,0,0,69,0,-69
15153,1,0,43,0,-43
15154,1,0,45,0,-45
15155,0,0,55,0,-55
15156,1,0,10,0,-10
15157,0,0,51,0,-51
15158,1,1,234,1988,1754
15159,1,0,30,0,-30
15160,0,0,33,0,-33
15161,0,0,57,0,-57
15162,1,1,511,1509,998
15163,0,0,108,0,-108
15164,1,1,205,1785,1580
15165,0,0,37,0,-37
15166,1,1,465,1230,765
15167,1,1,2296,1214,-1082
15168,1,0,27,0,-27
15169,0,0,58,0,-58
15170,1,0,24,0,-24
15171,1,0,0,0,0
15172,1,0,69,0,-69
15173,0,0,42,0,-42
15174,0,0,39,0,-39
15175,0,0,1,0,-1
15176,0,0,96,0,-96
15177,1,1,235,1346,1111
15178,1,1,768,1389,621
15179,1,0,58,0,-58
15180,1,0,67,0,-67
15181,0,0,31,0,-31
15182,1,1,1026,1519,493
15183,1,1,1852,1206,-646
15184,0,0,23,0,-23
15185,1,0,101,0,-101
15186,0,0,21,0,-21
15187,1,0,62,0,-62
15188,1,0,52,0,-52
15189,0,0,10,0,-10
15190,0,0,13,0,-13
15191,1,0,55,0,-55
15192,1,0,19,0,-19
15193,0,0,3,0,-3
15194,1,0,9,0,-9
15195,1,1,759,1326,567
15196,1,0,41,0,-41
15197,1,1,1448,1373,-75
15198,1,0,31,0,-31
15199,1,0,96,0,-96
15200,1,0,2,0,-2
15201,1,0,31,0,-31
15202,1,0,75,0,-75
15203,1,0,6,0,-6
15204,1,0,7,0,-7
15205,0,0,23,0,-23
15206,0,0,28,0,-28
15207,1,1,1400,1896,496
15208,1,0,18,0,-18
15209,1,1,231,2299,2068
15210,1,1,235,1570,1335
15211,0,0,0,0,0
15212,0,0,17,0,-17
15213,1,1,417,1298,881
15214,1,0,25,0,-25
15215,1,0,46,0,-46
15216,0,0,19,0,-19
15217,1,1,73,1356,1283
15218,0,0,69,0,-69
15219,1,1,11,1634,1623
15220,1,1,219,1250,1031
15221,0,0,24,0,-24
15222,1,1,246,1765,1519
15223,1,0,15,0,-15
15224,0,0,3,0,-3
15225,0,0,182,0,-182
15226,1,1,71,1305,1234
15227,1,0,42,0,-42
15228,1,0,34,0,-34
15229,1,1,380,1930,1550
15230,1,0,140,0,-140
15231,1,0,66,0,-66
15232,1,0,0,0,0
15233,0,0,27,0,-27
15234,1,0,59,0,-59
15235,0,0,125,0,-125
15236,1,0,7,0,-7
15237,0,0,23,0,-23
15238,1,0,0,0,0
15239,0,0,32,0,-32
15240,1,1,1075,1209,134
15241,1,1,152,1259,1107
15242,0,0,14,0,-14
15243,1,1,146,1659,1513
15244,1,1,875,1586,711
15245,0,0,4,0,-4
15246,1,1,238,1240,1002
15247,1,0,71,0,-71
15248,1,1,149,1460,1311
15249,1,1,387,2117,1730
15250,1,0,185,0,-185
15251,0,0,39,0,-39
15252,1,0,2,0,-2
15253,1,1,401,1857,1456
15254,0,0,130,0,-130
15255,0,0,11,0,-11
15256,1,0,120,0,-120
15257,0,0,87,0,-87
15258,0,0,1,0,-1
15259,0,0,41,0,-41
15260,1,1,282,1558,1276
15261,0,0,48,0,-48
15262,0,0,88,0,-88
15263,1,0,19,0,-19
15264,1,1,1467,1537,70
15265,1,0,61,0,-61
15266,1,1,238,1261,1023
15267,0,0,11,0,-11
15268,1,0,20,0,-20
15269,1,1,104,1243,1139
15270,1,0,15,0,-15
15271,0,0,188,0,-188
15272,0,0,54,0,-54
15273,1,0,40,0,-40
15274,1,1,1017,1244,227
15275,0,0,34,0,-34
15276,1,1,117,1345,1228
15277,0,0,139,0,-139
15278,0,0,3,0,-3
15279,0,0,44,0,-44
15280,1,0,40,0,-40
15281,1,1,145,1725,1580
15282,0,0,31,0,-31
15283,0,0,32,0,-32
15284,0,0,36,0,-36
15285,1,1,743,1238,495
15286,0,0,9,0,-9
15287,1,1,451,1447,996
15288,1,1,1002,1479,477
15289,1,1,580,1835,1255
15290,1,1,675,1910,1235
15291,0,0,10,0,-10
15292,0,0,101,0,-101
15293,0,0,43,0,-43
15294,0,0,37,0,-37
15295,1,0,2,0,-2
15296,0,0,0,0,0
15297,0,0,7,0,-7
15298,1,0,26,0,-26
15299,0,0,54,0,-54
15300,1,0,87,0,-87
15301,1,1,312,1444,1132
15302,0,0,25,0,-25
15303,0,0,84,0,-84
15304,0,0,71,0,-71
15305,1,1,30,1436,1406
15306,0,0,80,0,-80
15307,0,0,39,0,-39
15308,0,0,131,0,-131
15309,0,0,140,0,-140
15310,0,0,1,0,-1
15311,1,0,17,0,-17
15312,1,1,254,1529,1275
15313,0,0,59,0,-59
15314,0,0,90,0,-90
15315,1,1,337,1652,1315
15316,1,0,25,0,-25
15317,0,0,25,0,-25
15318,1,0,110,0,-110
15319,1,1,600,1530,930
15320,0,0,245,0,-245
15321,0,0,61,0,-61
15322,1,1,205,1780,1575
15323,1,1,75,1862,1787
15324,1,0,72,0,-72
15325,1,0,4,0,-4
15326,1,1,156,1389,1233
15327,1,0,75,0,-75
15328,0,0,41,0,-41
15329,0,0,29,0,-29
15330,1,1,26,1585,1559
15331,1,1,890,1332,442
15332,0,0,34,0,-34
15333,1,0,10,0,-10
15334,0,0,4,0,-4
15335,1,0,53,0,-53
15336,0,0,54,0,-54
15337,1,1,348,1253,905
15338,1,1,521,1766,1245
15339,0,0,34,0,-34
15340,1,0,4,0,-4
15341,1,0,55,0,-55
15342,1,0,28,0,-28
15343,1,0,11,0,-11
15344,1,1,307,1235,928
15345,1,1,1308,1311,3
15346,0,0,56,0,-56
15347,0,0,3,0,-3
15348,1,0,77,0,-77
15349,1,1,220,1522,1302
15350,1,0,1,0,-1
15351,1,0,53,0,-53
15352,1,1,39,1336,1297
15353,1,1,594,1537,943
15354,1,1,348,1591,1243
15355,1,0,6,0,-6
15356,0,0,13,0,-13
15357,1,0,60,0,-60
15358,0,0,103,0,-103
15359,0,0,17,0,-17
15360,1,1,372,1638,1266
15361,1,1,307,1206,899
15362,1,0,11,0,-11
15363,1,1,766,2157,1391
15364,0,0,36,0,-36
15365,0,0,3,0,-3
15366,0,0,61,0,-61
15367,0,0,4,0,-4
15368,1,1,321,1602,1281
15369,1,0,4,0,-4
15370,1,1,2291,1234,-1057
15371,0,0,9,0,-9
15372,0,0,72,0,-72
15373,0,0,8,0,-8
15374,1,0,249,0,-249
15375,1,0,19,0,-19
15376,0,0,45,0,-45
15377,0,0,166,0,-166
15378,1,0,90,0,-90
15379,0,0,24,0,-24
15380,1,1,200,1348,1148
15381,1,0,2,0,-2
15382,0,0,25,0,-25
15383,1,1,462,1626,1164
15384,1,0,81,0,-81
15385,1,1,202,1653,1451
15386,1,1,167,1603,1436
15387,0,0,33,0,-33
15388,1,1,274,1724,1450
15389,1,1,1040,1492,452
15390,1,0,24,0,-24
15391,1,0,67,0,-67
15392,1,0,20,0,-20
15393,1,0,29,0,-29
15394,0,0,18,0,-18
15395,1,1,1024,1281,257
15396,1,0,3,0,-3
15397,0,0,16,0,-16
15398,1,1,376,1573,1197
15399,1,1,282,2387,2105
15400,0,0,59,0,-59
15401,1,0,22,0,-22
15402,1,1,647,1237,590
15403,1,1,388,1464,1076
15404,1,1,1727,4689,2962
15405,1,1,363,3275,2912
15406,1,0,13,0,-13
15407,1,1,373,1930,1557
15408,1,1,294,1599,1305
15409,1,0,42,0,-42
15410,1,1,476,1813,1337
15411,0,0,31,0,-31
15412,0,0,77,0,-77
15413,1,0,11,0,-11
15414,1,0,8,0,-8
15415,0,0,38,0,-38
15416,1,1,668,1424,756
15417,1,1,422,1208,786
15418,1,0,146,0,-146
15419,0,0,77,0,-77
15420,1,1,211,2170,1959
15421,0,0,10,0,-10
15422,1,1,477,1493,1016
15423,0,0,196,0,-196
15424,1,1,500,1266,766
15425,0,0,85,0,-85
15426,0,0,71,0,-71
15427,0,0,6,0,-6
15428,0,0,23,0,-23
15429,0,0,130,0,-130
15430,0,0,8,0,-8
15431,1,0,7,0,-7
15432,1,1,324,1362,1038
15433,0,0,53,0,-53
15434,0,0,94,0,-94
15435,1,0,52,0,-52
15436,1,1,416,2719,2303
15437,1,0,143,0,-143
15438,0,0,55,0,-55
15439,1,0,15,0,-15
15440,0,0,29,0,-29
15441,1,0,5,0,-5
15442,1,1,240,1316,1076
15443,1,1,34,1404,1370
15444,1,0,60,0,-60
15445,0,0,88,0,-88
15446,0,0,19,0,-19
15447,0,0,79,0,-79
15448,0,0,7,0,-7
15449,1,0,46,0,-46
15450,1,0,60,0,-60
15451,0,0,0,0,0
15452,0,0,36,0,-36
15453,1,0,6,0,-6
15454,1,0,76,0,-76
15455,0,0,76,0,-76
15456,1,1,630,1406,776
15457,0,0,11,0,-11
15458,1,1,319,1218,899
15459,1,1,1256,1361,105
15460,1,0,161,0,-161
15461,1,1,342,1264,922
15462,1,1,246,1205,959
15463,0,0,43,0,-43
15464,0,0,83,0,-83
15465,1,0,5,0,-5
15466,1,1,1074,1402,328
15467,0,0,84,0,-84
15468,1,0,9,0,-9
15469,1,1,325,1719,1394
15470,1,0,3,0,-3
15471,1,0,25,0,-25
15472,1,1,1123,1228,105
15473,1,1,961,1210,249
15474,1,1,213,1400,1187
15475,0,0,44,0,-44
15476,0,0,38,0,-38
15477,1,0,90,0,-90
15478,1,0,2,0,-2
15479,1,0,103,0,-103
15480,1,0,20,0,-20
15481,1,1,215,1221,1006
15482,0,0,46,0,-46
15483,1,0,25,0,-25
15484,1,0,15,0,-15
15485,1,1,128,1841,1713
15486,0,0,1,0,-1
15487,1,0,168,0,-168
15488,1,0,44,0,-44
15489,1,0,51,0,-51
15490,0,0,20,0,-20
15491,1,1,875,1231,356
15492,0,0,15,0,-15
15493,1,1,213,1377,1164
15494,1,0,30,0,-30
15495,0,0,185,0,-185
15496,0,0,30,0,-30
15497,1,0,107,0,-107
15498,1,1,389,1512,1123
15499,0,0,37,0,-37
15500,0,0,40,0,-40
15501,0,0,8,0,-8
15502,0,0,107,0,-107
15503,1,1,386,1339,953
15504,1,0,21,0,-21
15505,0,0,135,0,-135
15506,1,0,35,0,-35
15507,0,0,17,0,-17
15508,0,0,25,0,-25
15509,1,0,110,0,-110
15510,1,0,22,0,-22
15511,0,0,60,0,-60
15512,1,0,23,0,-23
15513,1,0,66,0,-66
15514,1,0,14,0,-14
15515,1,0,4,0,-4
15516,0,0,4,0,-4
15517,1,0,25,0,-25
15518,1,0,83,0,-83
15519,1,0,91,0,-91
15520,0,0,25,0,-25
15521,1,0,30,0,-30
15522,0,0,73,0,-73
15523,0,0,43,0,-43
15524,1,1,57,1207,1150
15525,1,0,64,0,-64
15526,1,0,28,0,-28
15527,0,0,92,0,-92
15528,1,0,13,0,-13
15529,1,0,4,0,-4
15530,1,0,84,0,-84
15531,1,0,80,0,-80
15532,1,1,66,1259,1193
15533,1,0,21,0,-21
15534,1,0,37,0,-37
15535,1,1,202,1451,1249
15536,1,0,8,0,-8
15537,0,0,2,0,-2
15538,1,1,231,1249,1018
15539,1,0,111,0,-111
15540,1,0,3,0,-3
15541,1,1,1454,1251,-203
15542,0,0,109,0,-109
15543,1,0,104,0,-104
15544,0,0,8,0,-8
15545,1,0,10,0,-10
15546,1,1,274,1523,1249
15547,1,1,302,1279,977
15548,1,1,359,1297,938
15549,1,1,370,1291,921
15550,0,0,3,0,-3
15551,0,0,6,0,-6
15552,0,0,84,0,-84
15553,1,1,78,1327,1249
15554,0,0,5,0,-5
15555,1,0,17,0,-17
15556,0,0,13,0,-13
15557,1,1,375,1487,1112
15558,0,0,4,0,-4
15559,0,0,34,0,-34
15560,0,0,69,0,-69
15561,1,0,8,0,-8
15562,1,0,18,0,-18
15563,0,0,42,0,-42
15564,0,0,20,0,-20
15565,1,0,68,0,-68
15566,1,1,172,2738,2566
15567,1,0,51,0,-51
15568,1,0,35,0,-35
15569,1,1,474,1375,901
15570,0,0,33,0,-33
15571,1,0,28,0,-28
15572,1,0,25,0,-25
15573,1,1,320,2549,2229
15574,1,1,94,1655,1561
15575,0,0,49,0,-49
15576,0,0,48,0,-48
15577,1,0,29,0,-29
15578,1,0,20,0,-20
15579,0,0,7,0,-7
15580,1,0,1,0,-1
15581,1,1,201,1265,1064
15582,1,1,106,1404,1298
15583,1,0,26,0,-26
15584,1,1,229,1449,1220
15585,0,0,198,0,-198
15586,1,0,31,0,-31
15587,1,1,355,1451,1096
15588,1,1,282,1377,1095
15589,1,0,21,0,-21
15590,1,0,35,0,-35
15591,1,0,157,0,-157
15592,1,1,267,1423,1156
15593,1,0,85,0,-85
15594,1,0,84,0,-84
15595,1,1,1898,1263,-635
15596,1,1,145,1815,1670
15597,0,0,39,0,-39
15598,1,1,163,1245,1082
15599,1,0,9,0,-9
15600,1,1,924,1300,376
15601,1,0,0,0,0
15602,1,1,527,1267,740
15603,0,0,67,0,-67
15604,0,0,98,0,-98
15605,0,0,76,0,-76
15606,1,1,58,1396,1338
15607,1,1,555,5615,5060
15608,0,0,57,0,-57
15609,1,1,1090,1633,543
15610,0,0,12,0,-12
15611,0,0,17,0,-17
15612,1,0,19,0,-19
15613,1,0,2,0,-2
15614,0,0,32,0,-32
15615,0,0,24,0,-24
15616,1,1,878,2132,1254
15617,1,0,15,0,-15
15618,1,0,72,0,-72
15619,0,0,29,0,-29
15620,0,0,3,0,-3
15621,0,0,38,0,-38
15622,0,0,44,0,-44
15623,1,0,16,0,-16
15624,1,1,399,1325,926
15625,1,1,135,6189,6054
15626,0,0,9,0,-9
15627,0,0,10,0,-10
15628,1,1,169,1607,1438
15629,0,0,42,0,-42
15630,1,1,254,1581,1327
15631,1,0,33,0,-33
15632,0,0,97,0,-97
15633,1,1,291,2236,1945
15634,1,0,49,0,-49
15635,0,0,74,0,-74
15636,1,1,921,1353,432
15637,0,0,21,0,-21
15638,1,1,502,1380,878
15639,1,1,646,2439,1793
15640,1,0,40,0,-40
15641,1,0,18,0,-18
15642,0,0,29,0,-29
15643,0,0,21,0,-21
15644,0,0,178,0,-178
15645,1,0,0,0,0
15646,1,0,38,0,-38
15647,1,1,547,1212,665
15648,0,0,71,0,-71
15649,0,0,0,0,0
15650,1,0,37,0,-37
15651,1,0,32,0,-32
15652,0,0,15,0,-15
15653,1,0,55,0,-55
15654,0,0,139,0,-139
15655,1,1,279,1605,1326
15656,1,0,42,0,-42
15657,0,0,29,0,-29
15658,1,1,134,1332,1198
15659,0,0,0,0,0
15660,0,0,42,0,-42
15661,0,0,71,0,-71
15662,1,0,2,0,-2
15663,1,1,711,2101,1390
15664,1,1,579,1236,657
15665,1,0,148,0,-148
15666,1,0,7,0,-7
15667,0,0,19,0,-19
15668,1,1,199,1934,1735
15669,0,0,6,0,-6
15670,1,0,7,0,-7
15671,1,0,11,0,-11
15672,0,0,15,0,-15
15673,0,0,37,0,-37
15674,1,0,15,0,-15
15675,1,1,245,2305,2060
15676,1,0,117,0,-117
15677,1,1,1716,1208,-508
15678,1,1,80,1405,1325
15679,0,0,54,0,-54
15680,1,0,26,0,-26
15681,0,0,2,0,-2
15682,0,0,24,0,-24
15683,1,0,1,0,-1
15684,1,0,0,0,0
15685,0,0,42,0,-42
15686,1,1,139,1295,1156
15687,0,0,46,0,-46
15688,1,0,121,0,-121
15689,1,0,13,0,-13
15690,1,1,86,2509,2423
15691,0,0,0,0,0
15692,1,0,92,0,-92
15693,0,0,11,0,-11
15694,1,1,507,1200,693
15695,1,1,920,1803,883
15696,0,0,123,0,-123
15697,0,0,78,0,-78
15698,1,0,94,0,-94
15699,0,0,15,0,-15
15700,1,0,29,0,-29
15701,1,1,345,1224,879
15702,1,1,493,2787,2294
15703,1,1,398,1370,972
15704,0,0,175,0,-175
15705,0,0,54,0,-54
15706,1,0,100,0,-100
15707,1,1,1815,1505,-310
15708,1,1,275,1292,1017
15709,1,0,70,0,-70
15710,0,0,13,0,-13
15711,0,0,75,0,-75
15712,1,0,27,0,-27
15713,1,1,160,1206,1046
15714,1,0,6,0,-6
15715,1,0,87,0,-87
15716,1,1,110,1234,1124
15717,1,1,223,1289,1066
15718,0,0,43,0,-43
15719,1,0,91,0,-91
15720,1,0,15,0,-15
15721,1,1,439,1244,805
15722,0,0,94,0,-94
15723,1,1,491,1495,1004
15724,1,1,100,1974,1874
15725,0,0,45,0,-45
15726,0,0,10,0,-10
15727,1,1,1836,1550,-286
15728,0,0,55,0,-55
15729,0,0,48,0,-48
15730,0,0,80,0,-80
15731,1,0,47,0,-47
15732,1,1,785,1330,545
15733,1,0,2,0,-2
15734,0,0,137,0,-137
15735,0,0,27,0,-27
15736,0,0,273,0,-273
15737,1,0,42,0,-42
15738,1,0,12,0,-12
15739,1,1,32,1207,1175
15740,1,1,367,1311,944
15741,0,0,46,0,-46
15742,1,0,25,0,-25
15743,1,0,26,0,-26
15744,1,0,157,0,-157
15745,0,0,140,0,-140
15746,1,0,62,0,-62
15747,1,0,89,0,-89
15748,1,0,34,0,-34
15749,0,0,2,0,-2
15750,1,0,54,0,-54
15751,1,1,1527,2251,724
15752,1,0,3,0,-3
15753,0,0,44,0,-44
15754,1,0,17,0,-17
15755,1,0,40,0,-40
15756,1,0,17,0,-17
15757,1,1,100,1846,1746
15758,0,0,87,0,-87
15759,0,0,14,0,-14
15760,1,1,129,1220,1091
15761,0,0,131,0,-131
15762,1,0,2,0,-2
15763,1,0,63,0,-63
15764,1,1,377,1631,1254
15765,0,0,30,0,-30
15766,1,1,88,1442,1354
15767,0,0,41,0,-41
15768,1,0,71,0,-71
15769,1,0,47,0,-47
15770,1,1,140,1447,1307
15771,1,1,650,2102,1452
15772,0,0,49,0,-49
15773,0,0,136,0,-136
15774,0,0,48,0,-48
15775,1,1,212,1336,1124
15776,0,0,38,0,-38
15777,0,0,8,0,-8
15778,1,1,173,1230,1057
15779,1,1,895,1378,483
15780,1,0,13,0,-13
15781,0,0,258,0,-258
15782,0,0,171,0,-171
15783,0,0,27,0,-27
15784,1,1,581,1839,1258
15785,1,1,633,1249,616
15786,1,1,160,1216,1056
15787,1,1,1570,1296,-274
15788,1,1,224,1254,1030
15789,0,0,13,0,-13
15790,1,1,422,3546,3124
15791,1,1,450,2142,1692
15792,1,1,311,1552,1241
15793,1,0,5,0,-5
15794,1,1,246,1779,1533
15795,0,0,102,0,-102
15796,0,0,37,0,-37
15797,1,1,692,1220,528
15798,1,1,280,2715,2435
15799,0,0,5,0,-5
15800,1,1,168,2599,2431
15801,0,0,100,0,-100
15802,1,0,55,0,-55
15803,1,1,1756,1285,-471
15804,0,0,54,0,-54
15805,0,0,110,0,-110
15806,1,1,71,1585,1514
15807,1,1,401,1284,883
15808,1,1,1555,1223,-332
15809,1,0,49,0,-49
15810,1,1,980,1445,465
15811,1,1,74,2370,2296
15812,1,0,31,0,-31
15813,1,0,54,0,-54
15814,0,0,9,0,-9
15815,1,1,791,1464,673
15816,1,1,1607,1431,-176
15817,1,0,57,0,-57
15818,0,0,19,0,-19
15819,1,1,496,1633,1137
15820,0,0,91,0,-91
15821,1,0,77,0,-77
15822,1,1,48,1228,1180
15823,1,0,23,0,-23
15824,0,0,16,0,-16
15825,1,1,772,1284,512
15826,0,0,24,0,-24
15827,0,0,65,0,-65
15828,1,1,93,1562,1469
15829,1,1,326,1280,954
15830,1,1,33,1260,1227
15831,1,0,83,0,-83
15832,1,0,269,0,-269
15833,1,0,21,0,-21
15834,1,0,57,0,-57
15835,0,0,20,0,-20
15836,1,1,596,1468,872
15837,1,0,93,0,-93
15838,1,0,36,0,-36
15839,0,0,44,0,-44
15840,1,1,886,1248,362
15841,1,1,635,1462,827
15842,1,1,1387,1262,-125
15843,1,1,461,1227,766
15844,0,0,1,0,-1
15845,0,0,19,0,-19
15846,1,1,256,1309,1053
15847,1,0,30,0,-30
15848,0,0,18,0,-18
15849,0,0,20,0,-20
15850,1,0,53,0,-53
15851,1,1,176,1229,1053
15852,1,1,651,1474,823
15853,1,0,182,0,-182
15854,1,1,406,1411,1005
15855,0,0,20,0,-20
15856,1,0,41,0,-41
15857,1,1,812,1429,617
15858,1,0,22,0,-22
15859,1,1,10,1453,1443
15860,1,1,432,1233,801
15861,0,0,21,0,-21
15862,0,0,33,0,-33
15863,1,1,214,1846,1632
15864,0,0,153,0,-153
15865,1,1,1237,1338,101
15866,0,0,44,0,-44
15867,0,0,102,0,-102
15868,1,0,23,0,-23
15869,0,0,212,0,-212
15870,1,0,191,0,-191
15871,1,1,273,1298,1025
15872,1,0,130,0,-130
15873,0,0,5,0,-5
15874,1,1,190,1714,1524
15875,1,1,214,1611,1397
15876,1,0,259,0,-259
15877,1,1,183,1620,1437
15878,0,0,57,0,-57
15879,1,0,88,0,-88
15880,1,0,7,0,-7
15881,0,0,74,0,-74
15882,0,0,12,0,-12
15883,0,0,135,0,-135
15884,1,0,160,0,-160
15885,0,0,76,0,-76
15886,1,0,54,0,-54
15887,0,0,44,0,-44
15888,1,1,174,1360,1186
15889,0,0,6,0,-6
15890,1,0,107,0,-107
15891,0,0,59,0,-59
15892,0,0,100,0,-100
15893,0,0,47,0,-47
15894,0,0,87,0,-87
15895,1,0,23,0,-23
15896,0,0,124,0,-124
15897,1,1,466,2334,1868
15898,0,0,28,0,-28
15899,1,1,889,1289,400
15900,1,0,27,0,-27
15901,0,0,47,0,-47
15902,0,0,101,0,-101
15903,0,0,28,0,-28
15904,1,1,170,1305,1135
15905,1,0,68,0,-68
15906,0,0,67,0,-67
15907,1,1,1245,1381,136
15908,1,0,43,0,-43
15909,0,0,21,0,-21
15910,1,0,1,0,-1
15911,0,0,154,0,-154
15912,1,0,50,0,-50
15913,1,1,1240,1524,284
15914,0,0,3,0,-3
15915,0,0,18,0,-18
15916,0,0,1,0,-1
15917,1,1,644,1509,865
15918,1,1,232,1379,1147
15919,0,0,11,0,-11
15920,1,1,10,1251,1241
15921,0,0,0,0,0
15922,1,0,1,0,-1
15923,0,0,65,0,-65
15924,0,0,12,0,-12
15925,1,1,840,1587,747
15926,1,1,296,1620,1324
15927,1,1,230,1786,1556
15928,0,0,8,0,-8
15929,1,1,859,1423,564
15930,0,0,74,0,-74
15931,1,1,551,1280,729
15932,1,0,260,0,-260
15933,1,0,78,0,-78
15934,1,0,24,0,-24
15935,1,1,85,2605,2520
15936,1,1,238,1702,1464
15937,1,1,381,1275,894
15938,1,1,220,1248,1028
15939,1,0,16,0,-16
15940,0,0,50,0,-50
15941,1,0,25,0,-25
15942,1,0,40,0,-40
15943,0,0,174,0,-174
15944,0,0,57,0,-57
15945,1,1,801,1345,544
15946,0,0,7,0,-7
15947,0,0,0,0,0
15948,1,0,75,0,-75
15949,1,0,7,0,-7
15950,1,0,49,0,-49
15951,0,0,58,0,-58
15952,1,1,221,1837,1616
15953,1,0,22,0,-22
15954,1,1,1636,1715,79
15955,1,0,14,0,-14
15956,1,1,709,1446,737
15957,1,0,15,0,-15
15958,1,1,68,1245,1177
15959,1,0,13,0,-13
15960,1,1,140,1341,1201
15961,1,0,135,0,-135
15962,1,0,0,0,0
15963,1,1,24,1837,1813
15964,0,0,69,0,-69
15965,1,0,367,0,-367
15966,0,0,69,0,-69
15967,1,1,338,1641,1303
15968,1,0,32,0,-32
15969,0,0,5,0,-5
15970,1,0,27,0,-27
15971,0,0,91,0,-91
15972,0,0,62,0,-62
15973,0,0,11,0,-11
15974,1,1,420,2211,1791
15975,0,0,38,0,-38
15976,0,0,176,0,-176
15977,0,0,37,0,-37
15978,1,1,751,1265,514
15979,1,1,270,1276,1006
15980,1,0,58,0,-58
15981,0,0,7,0,-7
15982,1,1,664,1366,702
15983,0,0,86,0,-86
15984,0,0,1,0,-1
15985,1,1,191,1841,1650
15986,1,1,106,1530,1424
15987,1,0,30,0,-30
15988,1,1,607,1356,749
15989,1,0,59,0,-59
15990,1,1,394,1326,932
15991,1,1,354,3007,2653
15992,1,0,42,0,-42
15993,0,0,114,0,-114
15994,1,0,114,0,-114
15995,0,0,62,0,-62
15996,1,0,57,0,-57
15997,0,0,108,0,-108
15998,0,0,27,0,-27
15999,1,1,119,1402,1283
16000,1,0,58,0,-58
16001,1,1,610,2429,1819
16002,0,0,4,0,-4
16003,1,0,8,0,-8
16004,1,1,566,4471,3905
16005,0,0,105,0,-105
16006,1,1,637,1635,998
16007,1,1,635,1390,755
16008,1,0,47,0,-47
16009,1,0,18,0,-18
16010,1,1,669,1227,558
16011,1,1,147,1359,1212
16012,0,0,41,0,-41
16013,1,0,148,0,-148
16014,1,1,237,1200,963
16015,1,1,563,1218,655
16016,1,1,494,1250,756
16017,1,1,464,1510,1046
16018,1,1,77,1346,1269
16019,1,0,122,0,-122
16020,0,0,2,0,-2
16021,1,1,1040,2239,1199
16022,0,0,24,0,-24
16023,1,1,561,1503,942
16024,1,0,27,0,-27
16025,1,1,547,1572,1025
16026,1,1,566,1602,1036
16027,1,1,278,1330,1052
16028,1,1,617,1398,781
16029,0,0,175,0,-175
16030,1,1,153,2136,1983
16031,1,0,63,0,-63
16032,1,1,1039,1240,201
16033,0,0,205,0,-205
16034,1,1,699,1639,940
16035,1,0,49,0,-49
16036,0,0,77,0,-77
16037,1,0,118,0,-118
16038,1,1,1793,3527,1734
16039,1,1,248,1981,1733
16040,1,0,13,0,-13
16041,1,1,59,1284,1225
16042,0,0,34,0,-34
16043,1,1,196,1560,1364
16044,1,0,63,0,-63
16045,1,1,575,1329,754
16046,0,0,114,0,-114
16047,1,0,40,0,-40
16048,0,0,11,0,-11
16049,0,0,10,0,-10
16050,1,1,566,2279,1713
16051,0,0,7,0,-7
16052,0,0,45,0,-45
16053,1,1,771,1258,487
16054,0,0,11,0,-11
16055,0,0,27,0,-27
16056,1,0,124,0,-124
16057,0,0,124,0,-124
16058,1,1,47,1334,1287
16059,1,0,51,0,-51
16060,1,0,31,0,-31
16061,0,0,28,0,-28
16062,0,0,44,0,-44
16063,0,0,23,0,-23
16064,1,1,229,1382,1153
16065,1,1,277,1232,955
16066,0,0,51,0,-51
16067,0,0,19,0,-19
16068,1,0,34,0,-34
16069,0,0,83,0,-83
16070,1,0,11,0,-11
16071,1,0,31,0,-31
16072,1,0,27,0,-27
16073,1,0,15,0,-15
16074,0,0,2,0,-2
16075,1,1,175,1619,1444
16076,1,1,505,1288,783
16077,1,0,154,0,-154
16078,1,0,79,0,-79
16079,1,0,9,0,-9
16080,0,0,41,0,-41
16081,1,0,7,0,-7
16082,0,0,25,0,-25
16083,0,0,77,0,-77
16084,1,1,418,1755,1337
16085,0,0,78,0,-78
16086,0,0,68,0,-68
16087,0,0,15,0,-15
16088,1,0,284,0,-284
16089,1,1,26,1213,1187
16090,0,0,16,0,-16
16091,1,0,83,0,-83
16092,1,1,1074,1231,157
16093,1,1,183,1369,1186
16094,0,0,64,0,-64
16095,0,0,5,0,-5
16096,1,0,120,0,-120
16097,1,0,61,0,-61
16098,1,1,404,1601,1197
16099,1,0,122,0,-122
16100,0,0,77,0,-77
16101,1,1,549,1388,839
16102,1,0,86,0,-86
16103,1,1,528,1433,905
16104,1,1,55,1302,1247
16105,0,0,39,0,-39
16106,1,0,19,0,-19
16107,0,0,51,0,-51
16108,1,1,371,1398,1027
16109,0,0,4,0,-4
16110,0,0,16,0,-16
16111,1,1,493,1376,883
16112,1,1,440,1249,809
16113,1,0,118,0,-118
16114,1,1,366,1376,1010
16115,0,0,66,0,-66
16116,1,0,0,0,0
16117,1,0,27,0,-27
16118,1,1,600,1301,701
16119,1,1,176,1284,1108
16120,1,1,562,1455,893
16121,0,0,11,0,-11
16122,1,1,132,1535,1403
16123,1,1,246,2076,1830
16124,0,0,74,0,-74
16125,1,0,7,0,-7
16126,1,0,57,0,-57
16127,1,0,34,0,-34
16128,1,0,38,0,-38
16129,1,0,106,0,-106
16130,0,0,10,0,-10
16131,1,1,479,1216,737
16132,1,1,449,1619,1170
16133,1,1,648,1810,1162
16134,1,0,15,0,-15
16135,1,1,348,2788,2440
16136,0,0,97,0,-97
16137,1,1,913,1236,323
16138,1,1,773,1372,599
16139,1,1,365,1252,887
16140,1,1,377,1240,863
16141,0,0,114,0,-114
16142,1,0,98,0,-98
16143,0,0,47,0,-47
16144,1,0,65,0,-65
16145,1,1,321,1441,1120
16146,1,1,298,2305,2007
16147,1,1,292,1639,1347
16148,0,0,32,0,-32
16149,0,0,10,0,-10
16150,1,0,8,0,-8
16151,1,0,48,0,-48
16152,0,0,26,0,-26
16153,1,0,96,0,-96
16154,1,1,126,1421,1295
16155,1,0,15,0,-15
16156,0,0,10,0,-10
16157,0,0,99,0,-99
16158,0,0,28,0,-28
16159,0,0,73,0,-73
16160,0,0,21,0,-21
16161,0,0,18,0,-18
16162,0,0,6,0,-6
16163,1,1,164,1269,1105
16164,1,0,150,0,-150
16165,1,0,2,0,-2
16166,1,0,7,0,-7
16167,1,0,88,0,-88
16168,0,0,86,0,-86
16169,1,1,435,1715,1280
16170,1,1,394,1603,1209
16171,1,1,999,4206,3207
16172,1,0,6,0,-6
16173,1,1,483,1405,922
16174,1,1,1180,1378,198
16175,1,0,94,0,-94
16176,0,0,55,0,-55
16177,1,1,639,2519,1880
16178,0,0,13,0,-13
16179,1,0,12,0,-12
16180,1,1,292,1233,941
16181,1,0,50,0,-50
16182,1,1,684,1543,859
16183,0,0,20,0,-20
16184,1,0,134,0,-134
16185,1,1,38,1612,1574
16186,1,1,308,1222,914
16187,0,0,109,0,-109
16188,0,0,16,0,-16
16189,0,0,75,0,-75
16190,1,1,44,1232,1188
16191,0,0,51,0,-51
16192,0,0,16,0,-16
16193,1,0,25,0,-25
16194,1,0,11,0,-11
16195,0,0,191,0,-191
16196,1,0,111,0,-111
16197,1,1,803,1983,1180
16198,1,1,461,1626,1165
16199,0,0,9,0,-9
16200,1,1,191,1410,1219
16201,0,0,26,0,-26
16202,1,0,74,0,-74
16203,1,1,177,1487,1310
16204,1,1,655,1222,567
16205,0,0,18,0,-18
16206,1,1,1654,2749,1095
16207,1,1,29,1558,1529
16208,1,1,355,1614,1259
16209,1,0,157,0,-157
16210,0,0,70,0,-70
16211,1,0,7,0,-7
16212,1,0,24,0,-24
16213,1,1,14,1355,1341
16214,0,0,47,0,-47
16215,1,0,57,0,-57
16216,0,0,111,0,-111
16217,1,0,30,0,-30
16218,0,0,37,0,-37
16219,1,0,28,0,-28
16220,0,0,61,0,-61
16221,0,0,5,0,-5
16222,1,0,17,0,-17
16223,1,0,12,0,-12
16224,1,0,82,0,-82
16225,1,1,230,6748,6518
16226,0,0,15,0,-15
16227,1,0,95,0,-95
16228,1,0,120,0,-120
16229,0,0,1,0,-1
16230,1,1,152,1374,1222
16231,0,0,3,0,-3
16232,0,0,62,0,-62
16233,1,1,692,1203,511
16234,0,0,7,0,-7
16235,1,1,207,1332,1125
16236,1,0,6,0,-6
16237,1,1,256,1679,1423
16238,1,1,222,6924,6702
16239,0,0,44,0,-44
16240,0,0,55,0,-55
16241,1,1,31,1325,1294
16242,1,0,139,0,-139
16243,1,1,1403,1219,-184
16244,0,0,31,0,-31
16245,0,0,102,0,-102
16246,1,1,1876,1919,43
16247,0,0,62,0,-62
16248,1,1,1109,1223,114
16249,0,0,7,0,-7
16250,0,0,57,0,-57
16251,0,0,51,0,-51
16252,0,0,105,0,-105
16253,0,0,44,0,-44
16254,0,0,215,0,-215
16255,0,0,52,0,-52
16256,1,0,14,0,-14
16257,1,0,0,0,0
16258,0,0,31,0,-31
16259,0,0,23,0,-23
16260,0,0,36,0,-36
16261,1,0,142,0,-142
16262,0,0,74,0,-74
16263,1,1,391,1317,926
16264,1,1,389,2099,1710
16265,1,1,115,1696,1581
16266,1,1,303,1228,925
16267,1,0,9,0,-9
16268,0,0,29,0,-29
16269,0,0,54,0,-54
16270,1,0,103,0,-103
16271,1,0,3,0,-3
16272,0,0,23,0,-23
16273,1,1,408,1506,1098
16274,0,0,127,0,-127
16275,1,1,766,2157,1391
16276,1,0,208,0,-208
16277,0,0,32,0,-32
16278,1,1,1293,2121,828
16279,1,0,84,0,-84
16280,1,1,236,1259,1023
16281,0,0,2,0,-2
16282,1,1,345,1782,1437
16283,1,0,11,0,-11
16284,0,0,115,0,-115
16285,1,0,123,0,-123
16286,1,1,1682,1257,-425
16287,1,1,525,1329,804
16288,1,1,752,1229,477
16289,1,0,123,0,-123
16290,0,0,9,0,-9
16291,1,1,294,1216,922
16292,0,0,167,0,-167
16293,1,0,25,0,-25
16294,1,1,638,1320,682
16295,0,0,7,0,-7
16296,0,0,179,0,-179
16297,1,1,406,1350,944
16298,1,0,28,0,-28
16299,1,0,122,0,-122
16300,0,0,95,0,-95
16301,0,0,1,0,-1
16302,1,0,0,0,0
16303,1,0,33,0,-33
16304,1,0,53,0,-53
16305,1,1,291,1627,1336
16306,1,0,78,0,-78
16307,0,0,41,0,-41
16308,1,1,3504,1295,-2209
16309,0,0,25,0,-25
16310,1,0,14,0,-14
16311,0,0,38,0,-38
16312,1,0,18,0,-18
16313,1,1,142,1224,1082
16314,1,1,104,1226,1122
16315,1,1,873,1329,456
16316,0,0,19,0,-19
16317,1,1,80,1230,1150
16318,1,1,796,1225,429
16319,0,0,79,0,-79
16320,1,1,625,1491,866
16321,0,0,29,0,-29
16322,1,0,24,0,-24
16323,1,1,60,1486,1426
16324,0,0,76,0,-76
16325,0,0,24,0,-24
16326,1,1,650,1216,566
16327,1,0,0,0,0
16328,1,0,3,0,-3
16329,1,0,3,0,-3
16330,1,0,14,0,-14
16331,0,0,85,0,-85
16332,0,0,10,0,-10
16333,1,0,65,0,-65
16334,1,0,84,0,-84
16335,1,0,34,0,-34
16336,0,0,21,0,-21
16337,1,0,97,0,-97
16338,1,0,24,0,-24
16339,1,0,11,0,-11
16340,0,0,40,0,-40
16341,0,0,9,0,-9
16342,0,0,3,0,-3
16343,1,0,124,0,-124
16344,1,0,23,0,-23
16345,1,1,188,1464,1276
16346,1,1,635,1365,730
16347,1,0,34,0,-34
16348,1,1,651,1654,1003
16349,0,0,103,0,-103
16350,0,0,127,0,-127
16351,0,0,1,0,-1
16352,1,0,2,0,-2
16353,1,1,159,2018,1859
16354,0,0,94,0,-94
16355,0,0,229,0,-229
16356,0,0,59,0,-59
16357,1,1,475,1828,1353
16358,1,1,107,1833,1726
16359,1,1,476,1725,1249
16360,1,1,16,1253,1237
16361,1,0,11,0,-11
16362,1,1,1453,1256,-197
16363,1,0,64,0,-64
16364,1,1,180,1332,1152
16365,1,0,11,0,-11
16366,1,0,90,0,-90
16367,0,0,13,0,-13
16368,1,1,171,1441,1270
16369,1,1,397,1559,1162
16370,1,0,31,0,-31
16371,0,0,40,0,-40
16372,1,1,1176,1290,114
16373,1,0,128,0,-128
16374,1,0,17,0,-17
16375,1,0,66,0,-66
16376,1,1,210,1915,1705
16377,0,0,25,0,-25
16378,1,1,447,1660,1213
16379,1,0,75,0,-75
16380,1,1,4410,1355,-3055
16381,1,1,371,1222,851
16382,0,0,62,0,-62
16383,1,0,21,0,-21
16384,1,0,8,0,-8
16385,0,0,12,0,-12
16386,1,1,1036,2039,1003
16387,1,1,901,1445,544
16388,0,0,106,0,-106
16389,0,0,24,0,-24
16390,0,0,56,0,-56
16391,1,1,266,1619,1353
16392,0,0,25,0,-25
16393,1,0,9,0,-9
16394,1,1,489,1428,939
16395,1,0,38,0,-38
16396,1,0,31,0,-31
16397,1,0,16,0,-16
16398,1,1,305,1806,1501
16399,1,0,50,0,-50
16400,0,0,114,0,-114
16401,1,1,1904,1417,-487
16402,1,0,121,0,-121
16403,1,1,513,1906,1393
16404,0,0,93,0,-93
16405,0,0,16,0,-16
16406,0,0,5,0,-5
16407,0,0,51,0,-51
16408,1,0,8,0,-8
16409,0,0,60,0,-60
16410,1,0,137,0,-137
16411,1,1,1229,1328,99
16412,1,0,42,0,-42
16413,0,0,92,0,-92
16414,1,0,16,0,-16
16415,1,1,324,1258,934
16416,0,0,17,0,-17
16417,1,1,82,1554,1472
16418,0,0,1,0,-1
16419,0,0,7,0,-7
16420,1,1,310,1466,1156
16421,0,0,28,0,-28
16422,1,1,564,1231,667
16423,1,0,16,0,-16
16424,1,0,55,0,-55
16425,1,0,18,0,-18
16426,1,1,1945,1274,-671
16427,1,0,8,0,-8
16428,1,0,69,0,-69
16429,0,0,48,0,-48
16430,0,0,52,0,-52
16431,1,1,1240,1307,67
16432,1,0,230,0,-230
16433,1,0,16,0,-16
16434,1,0,11,0,-11
16435,1,1,568,1250,682
16436,0,0,33,0,-33
16437,1,0,44,0,-44
16438,1,1,127,2837,2710
16439,1,0,183,0,-183
16440,0,0,52,0,-52
16441,0,0,6,0,-6
16442,1,1,1879,1383,-496
16443,1,0,7,0,-7
16444,0,0,155,0,-155
16445,0,0,195,0,-195
16446,1,1,426,1964,1538
16447,1,1,106,1470,1364
16448,0,0,32,0,-32
16449,0,0,4,0,-4
16450,0,0,28,0,-28
16451,1,1,75,1373,1298
16452,1,1,819,1217,398
16453,1,1,291,1265,974
16454,1,1,184,2130,1946
16455,0,0,35,0,-35
16456,1,0,1,0,-1
16457,1,1,586,1798,1212
16458,1,1,344,2615,2271
16459,1,1,118,1548,1430
16460,0,0,0,0,0
16461,1,0,1,0,-1
16462,0,0,14,0,-14
16463,1,0,19,0,-19
16464,1,0,2,0,-2
16465,1,0,15,0,-15
16466,0,0,13,0,-13
16467,1,1,491,1324,833
16468,1,1,140,1209,1069
16469,1,0,64,0,-64
16470,0,0,15,0,-15
16471,1,0,37,0,-37
16472,0,0,6,0,-6
16473,1,0,109,0,-109
16474,1,1,266,1431,1165
16475,1,1,563,1673,1110
16476,1,1,185,1444,1259
16477,0,0,16,0,-16
16478,1,1,783,1398,615
16479,1,0,374,0,-374
16480,1,1,24,1555,1531
16481,0,0,100,0,-100
16482,0,0,41,0,-41
16483,0,0,80,0,-80
16484,1,1,167,1239,1072
16485,1,0,31,0,-31
16486,1,1,242,1667,1425
16487,1,0,260,0,-260
16488,1,0,67,0,-67
16489,0,0,35,0,-35
16490,1,0,228,0,-228
16491,0,0,63,0,-63
16492,0,0,102,0,-102
16493,1,1,296,1300,1004
16494,0,0,3,0,-3
16495,1,1,108,2748,2640
16496,1,0,74,0,-74
16497,0,0,5,0,-5
16498,0,0,10,0,-10
16499,1,1,504,1554,1050
16500,1,1,1009,1438,429
16501,0,0,37,0,-37
16502,0,0,111,0,-111
16503,1,1,228,4454,4226
16504,0,0,68,0,-68
16505,1,1,116,1488,1372
16506,0,0,7,0,-7
16507,0,0,171,0,-171
16508,1,0,53,0,-53
16509,1,0,98,0,-98
16510,1,0,0,0,0
16511,1,0,0,0,0
16512,0,0,18,0,-18
16513,1,0,127,0,-127
16514,0,0,20,0,-20
16515,1,1,188,1478,1290
16516,0,0,99,0,-99
16517,1,1,746,1942,1196
16518,1,0,55,0,-55
16519,0,0,139,0,-139
16520,0,0,9,0,-9
16521,0,0,33,0,-33
16522,0,0,20,0,-20
16523,0,0,3,0,-3
16524,0,0,35,0,-35
16525,1,0,4,0,-4
16526,0,0,7,0,-7
16527,0,0,93,0,-93
16528,1,1,133,1425,1292
16529,0,0,28,0,-28
16530,1,1,48,1310,1262
16531,0,0,3,0,-3
16532,0,0,7,0,-7
16533,1,1,129,1519,1390
16534,0,0,5,0,-5
16535,1,0,43,0,-43
16536,0,0,49,0,-49
16537,1,1,1169,1545,376
16538,0,0,33,0,-33
16539,1,1,401,1379,978
16540,0,0,59,0,-59
16541,0,0,37,0,-37
16542,1,1,366,1600,1234
16543,1,1,690,1734,1044
16544,1,1,338,1511,1173
16545,1,1,865,1283,418
16546,1,1,1441,1307,-134
16547,0,0,7,0,-7
16548,1,0,6,0,-6
16549,1,1,88,1254,1166
16550,0,0,18,0,-18
16551,0,0,14,0,-14
16552,0,0,4,0,-4
16553,1,0,76,0,-76
16554,0,0,32,0,-32
16555,0,0,57,0,-57
16556,0,0,78,0,-78
16557,1,0,93,0,-93
16558,0,0,104,0,-104
16559,0,0,51,0,-51
16560,0,0,94,0,-94
16561,1,1,713,1229,516
16562,1,0,22,0,-22
16563,1,0,10,0,-10
16564,0,0,3,0,-3
16565,1,1,249,1618,1369
16566,1,1,297,1237,940
16567,0,0,6,0,-6
16568,0,0,2,0,-2
16569,0,0,89,0,-89
16570,1,1,70,1361,1291
16571,1,0,40,0,-40
16572,1,1,17,1300,1283
16573,1,1,835,1568,733
16574,1,1,238,1912,1674
16575,1,0,12,0,-12
16576,1,1,365,1341,976
16577,1,1,571,2324,1753
16578,1,0,53,0,-53
16579,1,0,66,0,-66
16580,0,0,264,0,-264
16581,1,0,22,0,-22
16582,1,1,2945,1311,-1634
16583,1,0,8,0,-8
16584,1,0,29,0,-29
16585,0,0,1,0,-1
16586,0,0,39,0,-39
16587,1,0,43,0,-43
16588,1,0,10,0,-10
16589,1,0,53,0,-53
16590,1,1,926,1485,559
16591,1,0,124,0,-124
16592,1,0,39,0,-39
16593,1,0,80,0,-80
16594,0,0,72,0,-72
16595,1,0,6,0,-6
16596,0,0,88,0,-88
16597,1,1,296,1396,1100
16598,1,1,34,1407,1373
16599,0,0,60,0,-60
16600,1,1,300,1248,948
16601,1,1,164,1283,1119
16602,0,0,69,0,-69
16603,1,0,58,0,-58
16604,0,0,67,0,-67
16605,1,1,1655,1394,-261
16606,0,0,1,0,-1
16607,1,0,81,0,-81
16608,1,0,2,0,-2
16609,0,0,16,0,-16
16610,1,0,66,0,-66
16611,0,0,62,0,-62
16612,0,0,163,0,-163
16613,0,0,28,0,-28
16614,0,0,21,0,-21
16615,1,0,17,0,-17
16616,0,0,77,0,-77
16617,0,0,10,0,-10
16618,0,0,41,0,-41
16619,0,0,105,0,-105
16620,1,0,8,0,-8
16621,0,0,2,0,-2
16622,0,0,85,0,-85
16623,0,0,8,0,-8
16624,1,1,183,1321,1138
16625,0,0,6,0,-6
16626,1,1,554,1366,812
16627,1,0,7,0,-7
16628,1,1,246,2383,2137
16629,0,0,38,0,-38
16630,0,0,94,0,-94
16631,0,0,15,0,-15
16632,1,1,13,1888,1875
16633,1,0,62,0,-62
16634,0,0,25,0,-25
16635,1,0,0,0,0
16636,1,0,184,0,-184
16637,1,1,32,1797,1765
16638,0,0,2,0,-2
16639,0,0,36,0,-36
16640,0,0,30,0,-30
16641,0,0,19,0,-19
16642,1,1,227,1320,1093
16643,1,0,23,0,-23
16644,1,0,94,0,-94
16645,1,0,55,0,-55
16646,1,1,2045,1234,-811
16647,1,0,60,0,-60
16648,0,0,41,0,-41
16649,0,0,10,0,-10
16650,1,0,29,0,-29
16651,0,0,26,0,-26
16652,1,1,925,1336,411
16653,0,0,61,0,-61
16654,1,0,107,0,-107
16655,0,0,11,0,-11
16656,0,0,74,0,-74
16657,1,1,951,1376,425
16658,0,0,4,0,-4
16659,1,1,243,1352,1109
16660,1,1,205,1338,1133
16661,0,0,90,0,-90
16662,1,0,20,0,-20
16663,0,0,69,0,-69
16664,1,1,1004,1535,531
16665,1,0,5,0,-5
16666,1,0,26,0,-26
16667,1,0,46,0,-46
16668,0,0,225,0,-225
16669,0,0,4,0,-4
16670,1,0,4,0,-4
16671,1,0,57,0,-57
16672,1,1,143,1462,1319
16673,1,0,3,0,-3
16674,0,0,94,0,-94
16675,0,0,80,0,-80
16676,0,0,111,0,-111
16677,1,1,1567,1533,-34
16678,1,1,491,1413,922
16679,1,1,529,1410,881
16680,1,0,105,0,-105
16681,0,0,18,0,-18
16682,1,1,848,1347,499
16683,0,0,35,0,-35
16684,1,1,561,1730,1169
16685,0,0,38,0,-38
16686,1,0,73,0,-73
16687,1,1,513,1607,1094
16688,1,1,346,1612,1266
16689,1,0,97,0,-97
16690,1,1,212,1631,1419
16691,1,1,117,2527,2410
16692,1,1,715,1347,632
16693,1,0,20,0,-20
16694,1,0,16,0,-16
16695,1,0,12,0,-12
16696,0,0,29,0,-29
16697,1,0,65,0,-65
16698,1,1,1779,1341,-438
16699,1,1,940,1202,262
16700,1,0,33,0,-33
16701,0,0,37,0,-37
16702,1,0,81,0,-81
16703,1,0,32,0,-32
16704,0,0,4,0,-4
16705,0,0,46,0,-46
16706,0,0,26,0,-26
16707,1,1,90,1257,1167
16708,0,0,172,0,-172
16709,0,0,54,0,-54
16710,0,0,22,0,-22
16711,0,0,1,0,-1
16712,0,0,93,0,-93
16713,1,0,16,0,-16
16714,0,0,17,0,-17
16715,0,0,50,0,-50
16716,1,1,1473,1412,-61
16717,0,0,20,0,-20
16718,0,0,52,0,-52
16719,1,0,17,0,-17
16720,1,1,1416,1295,-121
16721,0,0,60,0,-60
16722,0,0,35,0,-35
16723,1,1,85,1382,1297
16724,1,1,622,1963,1341
16725,0,0,55,0,-55
16726,1,1,734,1495,761
16727,1,1,184,1536,1352
16728,1,1,483,2100,1617
16729,1,0,115,0,-115
16730,1,0,27,0,-27
16731,1,0,86,0,-86
16732,1,1,928,1878,950
16733,1,1,305,1979,1674
16734,1,0,18,0,-18
16735,1,1,377,2010,1633
16736,0,0,11,0,-11
16737,1,0,8,0,-8
16738,0,0,5,0,-5
16739,0,0,11,0,-11
16740,0,0,22,0,-22
16741,0,0,87,0,-87
16742,1,0,65,0,-65
16743,0,0,62,0,-62
16744,0,0,66,0,-66
16745,1,1,360,1356,996
16746,0,0,1,0,-1
16747,1,1,807,3037,2230
16748,0,0,64,0,-64
16749,0,0,50,0,-50
16750,1,0,67,0,-67
16751,0,0,27,0,-27
16752,0,0,18,0,-18
16753,0,0,28,0,-28
16754,1,1,405,1633,1228
16755,1,0,25,0,-25
16756,1,0,35,0,-35
16757,0,0,10,0,-10
16758,1,0,25,0,-25
16759,1,0,0,0,0
16760,1,0,10,0,-10
16761,1,1,156,1225,1069
16762,0,0,97,0,-97
16763,1,0,49,0,-49
16764,0,0,11,0,-11
16765,1,0,23,0,-23
16766,0,0,26,0,-26
16767,1,0,39,0,-39
16768,1,1,219,1520,1301
16769,1,1,491,2453,1962
16770,1,1,227,1551,1324
16771,0,0,5,0,-5
16772,0,0,4,0,-4
16773,0,0,52,0,-52
16774,0,0,87,0,-87
16775,0,0,126,0,-126
16776,0,0,18,0,-18
16777,1,0,104,0,-104
16778,0,0,16,0,-16
16779,0,0,73,0,-73
16780,0,0,9,0,-9
16781,0,0,197,0,-197
16782,1,1,491,1351,860
16783,1,0,1,0,-1
16784,1,0,35,0,-35
16785,1,0,41,0,-41
16786,1,1,216,1313,1097
16787,0,0,8,0,-8
16788,0,0,80,0,-80
16789,1,0,19,0,-19
16790,1,0,34,0,-34
16791,1,0,75,0,-75
16792,1,1,170,1339,1169
16793,0,0,27,0,-27
16794,0,0,1,0,-1
16795,1,1,91,1414,1323
16796,0,0,22,0,-22
16797,1,0,22,0,-22
16798,0,0,60,0,-60
16799,1,0,21,0,-21
16800,1,0,118,0,-118
16801,1,1,312,1477,1165
16802,0,0,16,0,-16
16803,0,0,38,0,-38
16804,1,1,139,1360,1221
16805,0,0,2,0,-2
16806,1,1,65,1340,1275
16807,1,0,134,0,-134
16808,1,1,181,1387,1206
16809,1,1,529,1705,1176
16810,0,0,102,0,-102
16811,1,1,222,1423,1201
16812,1,1,869,4360,3491
16813,1,0,93,0,-93
16814,1,0,70,0,-70
16815,1,0,165,0,-165
16816,1,0,14,0,-14
16817,1,0,31,0,-31
16818,1,0,18,0,-18
16819,0,0,138,0,-138
16820,1,0,18,0,-18
16821,1,0,21,0,-21
16822,0,0,10,0,-10
16823,0,0,64,0,-64
16824,0,0,19,0,-19
16825,0,0,336,0,-336
16826,1,1,422,1213,791
16827,1,0,25,0,-25
16828,1,0,54,0,-54
16829,1,0,54,0,-54
16830,1,0,45,0,-45
16831,1,1,12,1810,1798
16832,1,1,254,2707,2453
16833,1,1,192,1202,1010
16834,1,0,0,0,0
16835,1,1,364,1610,1246
16836,0,0,179,0,-179
16837,0,0,51,0,-51
16838,1,1,152,1516,1364
16839,1,0,147,0,-147
16840,0,0,126,0,-126
16841,1,0,24,0,-24
16842,1,0,123,0,-123
16843,1,1,451,1526,1075
16844,1,0,75,0,-75
16845,1,0,35,0,-35
16846,1,1,1456,1553,97
16847,1,0,52,0,-52
16848,0,0,80,0,-80
16849,0,0,54,0,-54
16850,1,0,37,0,-37
16851,1,1,170,1588,1418
16852,0,0,88,0,-88
16853,1,1,394,1973,1579
16854,1,0,8,0,-8
16855,1,1,195,1209,1014
16856,1,0,0,0,0
16857,0,0,40,0,-40
16858,1,1,260,1308,1048
16859,1,0,3,0,-3
16860,0,0,2,0,-2
16861,0,0,35,0,-35
16862,1,1,169,1280,1111
16863,1,0,34,0,-34
16864,1,1,689,1561,872
16865,0,0,38,0,-38
16866,1,0,2,0,-2
16867,0,0,27,0,-27
16868,0,0,85,0,-85
16869,1,0,60,0,-60
16870,1,0,64,0,-64
16871,1,0,33,0,-33
16872,1,1,189,1566,1377
16873,1,1,440,1350,910
16874,1,0,165,0,-165
16875,0,0,50,0,-50
16876,0,0,23,0,-23
16877,1,1,326,1229,903
16878,1,0,150,0,-150
16879,1,1,399,1322,923
16880,0,0,5,0,-5
16881,1,1,1079,1401,322
16882,0,0,0,0,0
16883,1,1,217,1281,1064
16884,0,0,18,0,-18
16885,1,1,1049,1867,818
16886,1,0,23,0,-23
16887,0,0,5,0,-5
16888,0,0,139,0,-139
16889,1,1,1928,1235,-693
16890,0,0,48,0,-48
16891,1,1,61,1577,1516
16892,1,0,37,0,-37
16893,0,0,11,0,-11
16894,0,0,59,0,-59
16895,0,0,10,0,-10
16896,0,0,81,0,-81
16897,1,1,42,1800,1758
16898,1,0,1,0,-1
16899,0,0,175,0,-175
16900,1,1,631,1242,611
16901,1,1,450,1615,1165
16902,0,0,52,0,-52
16903,1,0,3,0,-3
16904,0,0,29,0,-29
16905,0,0,54,0,-54
16906,1,0,72,0,-72
16907,1,0,7,0,-7
16908,1,1,1048,1424,376
16909,0,0,15,0,-15
16910,0,0,5,0,-5
16911,0,0,143,0,-143
16912,0,0,26,0,-26
16913,0,0,88,0,-88
16914,0,0,2,0,-2
16915,1,0,11,0,-11
16916,0,0,48,0,-48
16917,0,0,10,0,-10
16918,1,0,162,0,-162
16919,0,0,75,0,-75
16920,1,1,163,1222,1059
16921,1,1,690,1288,598
16922,0,0,204,0,-204
16923,1,1,567,1205,638
16924,1,0,42,0,-42
16925,0,0,45,0,-45
16926,0,0,11,0,-11
16927,1,1,104,1254,1150
16928,1,1,257,1403,1146
16929,1,0,14,0,-14
16930,1,0,119,0,-119
16931,1,0,9,0,-9
16932,1,0,6,0,-6
16933,1,1,169,1269,1100
16934,1,0,19,0,-19
16935,1,1,26,1252,1226
16936,1,0,15,0,-15
16937,1,1,1283,1303,20
16938,0,0,20,0,-20
16939,1,0,51,0,-51
16940,1,1,141,1320,1179
16941,1,0,26,0,-26
16942,1,0,15,0,-15
16943,1,1,428,1989,1561
16944,1,1,360,1572,1212
16945,1,0,91,0,-91
16946,1,0,30,0,-30
16947,1,1,48,2539,2491
16948,1,1,132,1218,1086
16949,0,0,70,0,-70
16950,0,0,22,0,-22
16951,1,1,192,1444,1252
16952,1,0,7,0,-7
16953,0,0,141,0,-141
16954,1,1,396,1326,930
16955,1,1,67,1369,1302
16956,1,0,20,0,-20
16957,1,1,602,2018,1416
16958,0,0,12,0,-12
16959,1,0,55,0,-55
16960,1,1,158,1263,1105
16961,0,0,32,0,-32
16962,1,1,699,1342,643
16963,0,0,40,0,-40
16964,1,0,3,0,-3
16965,0,0,137,0,-137
16966,0,0,55,0,-55
16967,0,0,27,0,-27
16968,1,1,149,1378,1229
16969,0,0,36,0,-36
16970,0,0,80,0,-80
16971,1,0,88,0,-88
16972,0,0,101,0,-101
16973,1,0,24,0,-24
16974,0,0,18,0,-18
16975,1,1,369,1269,900
16976,1,0,4,0,-4
16977,0,0,1,0,-1
16978,0,0,99,0,-99
16979,0,0,38,0,-38
16980,1,0,38,0,-38
16981,0,0,27,0,-27
16982,1,0,38,0,-38
16983,0,0,1,0,-1
16984,1,0,24,0,-24
16985,0,0,25,0,-25
16986,1,0,51,0,-51
16987,1,1,519,1298,779
16988,1,0,25,0,-25
16989,0,0,3,0,-3
16990,0,0,53,0,-53
16991,1,0,34,0,-34
16992,1,1,254,1403,1149
16993,1,0,25,0,-25
16994,0,0,17,0,-17
16995,1,1,213,1850,1637
16996,0,0,36,0,-36
16997,0,0,20,0,-20
16998,1,0,2,0,-2
16999,0,0,79,0,-79
17000,0,0,211,0,-211
17001,0,0,7,0,-7
17002,0,0,18,0,-18
17003,1,0,24,0,-24
17004,1,0,68,0,-68
17005,1,0,3,0,-3
17006,1,0,24,0,-24
17007,1,0,4,0,-4
17008,1,0,2,0,-2
17009,1,0,26,0,-26
17010,1,1,616,1211,595
17011,0,0,67,0,-67
17012,0,0,151,0,-151
17013,0,0,65,0,-65
17014,1,1,367,1255,888
17015,1,0,94,0,-94
17016,0,0,37,0,-37
17017,0,0,56,0,-56
17018,0,0,74,0,-74
17019,0,0,14,0,-14
17020,0,0,20,0,-20
17021,1,0,102,0,-102
17022,1,0,263,0,-263
17023,1,1,296,1661,1365
17024,0,0,15,0,-15
17025,1,0,62,0,-62
17026,1,0,35,0,-35
17027,1,0,57,0,-57
17028,1,1,101,1305,1204
17029,0,0,46,0,-46
17030,0,0,19,0,-19
17031,0,0,80,0,-80
17032,1,0,65,0,-65
17033,1,1,71,1330,1259
17034,0,0,3,0,-3
17035,1,1,98,1973,1875
17036,0,0,18,0,-18
17037,1,0,70,0,-70
17038,1,1,64,1993,1929
17039,1,1,465,1420,955
17040,1,0,40,0,-40
17041,0,0,13,0,-13
17042,1,0,24,0,-24
17043,1,1,428,1519,1091
17044,1,0,88,0,-88
17045,1,1,1399,2371,972
17046,1,1,839,2194,1355
17047,1,1,220,1536,1316
17048,1,0,31,0,-31
17049,0,0,28,0,-28
17050,1,0,120,0,-120
17051,0,0,43,0,-43
17052,1,1,751,1372,621
17053,0,0,83,0,-83
17054,1,0,16,0,-16
17055,1,0,13,0,-13
17056,0,0,32,0,-32
17057,1,1,493,2248,1755
17058,0,0,7,0,-7
17059,0,0,122,0,-122
17060,1,1,153,1234,1081
17061,1,0,6,0,-6
17062,1,1,65,1235,1170
17063,1,0,33,0,-33
17064,0,0,0,0,0
17065,0,0,44,0,-44
17066,1,1,734,1406,672
17067,0,0,100,0,-100
17068,1,0,27,0,-27
17069,0,0,228,0,-228
17070,1,0,49,0,-49
17071,1,1,1195,1817,622
17072,0,0,0,0,0
17073,1,1,608,1535,927
17074,1,0,28,0,-28
17075,1,1,1026,1826,800
17076,0,0,78,0,-78
17077,1,0,7,0,-7
17078,0,0,34,0,-34
17079,1,0,14,0,-14
17080,1,1,355,1405,1050
17081,0,0,44,0,-44
17082,0,0,19,0,-19
17083,1,0,2,0,-2
17084,0,0,39,0,-39
17085,1,1,351,3363,3012
17086,1,1,959,1291,332
17087,0,0,41,0,-41
17088,0,0,14,0,-14
17089,1,0,2,0,-2
17090,1,1,23,1393,1370
17091,1,0,17,0,-17
17092,1,0,21,0,-21
17093,0,0,36,0,-36
17094,1,0,5,0,-5
17095,1,0,33,0,-33
17096,0,0,4,0,-4
17097,1,1,292,1972,1680
17098,1,0,9,0,-9
17099,1,0,67,0,-67
17100,1,0,52,0,-52
17101,1,1,2222,1248,-974
17102,1,1,627,1503,876
17103,0,0,26,0,-26
17104,1,1,373,1263,890
17105,1,1,652,1202,550
17106,0,0,40,0,-40
17107,0,0,89,0,-89
17108,1,1,173,1401,1228
17109,0,0,118,0,-118
17110,1,1,92,1624,1532
17111,1,1,225,1475,1250
17112,0,0,1,0,-1
17113,1,0,82,0,-82
17114,1,0,31,0,-31
17115,1,0,7,0,-7
17116,1,1,967,1366,399
17117,0,0,20,0,-20
17118,1,0,4,0,-4
17119,1,0,225,0,-225
17120,0,0,29,0,-29
17121,0,0,8,0,-8
17122,1,1,146,3539,3393
17123,0,0,46,0,-46
17124,0,0,3,0,-3
17125,1,0,10,0,-10
17126,1,0,55,0,-55
17127,1,1,2486,1401,-1085
17128,0,0,138,0,-138
17129,0,0,17,0,-17
17130,1,1,527,1238,711
17131,1,0,134,0,-134
17132,1,0,31,0,-31
17133,0,0,55,0,-55
17134,0,0,38,0,-38
17135,1,0,23,0,-23
17136,0,0,71,0,-71
17137,1,1,98,1205,1107
17138,1,0,26,0,-26
17139,1,0,3,0,-3
17140,1,1,431,1238,807
17141,0,0,12,0,-12
17142,1,1,179,2254,2075
17143,1,1,353,1210,857
17144,1,1,3084,1218,-1866
17145,0,0,11,0,-11
17146,0,0,86,0,-86
17147,0,0,3,0,-3
17148,0,0,6,0,-6
17149,1,0,64,0,-64
17150,1,1,415,1762,1347
17151,0,0,4,0,-4
17152,1,0,46,0,-46
17153,1,0,173,0,-173
17154,0,0,37,0,-37
17155,1,1,677,1606,929
17156,0,0,8,0,-8
17157,0,0,77,0,-77
17158,1,0,37,0,-37
17159,0,0,0,0,0
17160,1,1,432,1452,1020
17161,1,0,24,0,-24
17162,0,0,125,0,-125
17163,1,1,307,1733,1426
17164,1,0,32,0,-32
17165,1,1,103,1840,1737
17166,1,1,438,1427,989
17167,0,0,20,0,-20
17168,1,1,214,1844,1630
17169,0,0,70,0,-70
17170,1,0,96,0,-96
17171,0,0,123,0,-123
17172,0,0,14,0,-14
17173,1,0,19,0,-19
17174,0,0,345,0,-345
17175,0,0,32,0,-32
17176,0,0,15,0,-15
17177,1,1,398,1348,950
17178,1,1,505,1408,903
17179,1,0,184,0,-184
17180,1,1,416,1536,1120
17181,1,0,12,0,-12
17182,1,0,71,0,-71
17183,0,0,121,0,-121
17184,1,0,68,0,-68
17185,0,0,89,0,-89
17186,0,0,23,0,-23
17187,0,0,65,0,-65
17188,1,1,212,3114,2902
17189,0,0,19,0,-19
17190,0,0,13,0,-13
17191,1,1,506,4137,3631
17192,1,0,92,0,-92
17193,1,0,39,0,-39
17194,1,0,50,0,-50
17195,0,0,16,0,-16
17196,1,1,327,2446,2119
17197,1,0,40,0,-40
17198,1,1,2105,1314,-791
17199,1,1,725,1210,485
17200,0,0,56,0,-56
17201,1,1,401,1284,883
17202,1,1,636,1463,827
17203,1,1,143,2211,2068
17204,0,0,13,0,-13
17205,0,0,31,0,-31
17206,0,0,100,0,-100
17207,0,0,1,0,-1
17208,1,1,123,1454,1331
17209,1,0,36,0,-36
17210,0,0,44,0,-44
17211,1,0,73,0,-73
17212,1,1,418,1215,797
17213,1,0,38,0,-38
17214,0,0,28,0,-28
17215,1,0,57,0,-57
17216,1,0,8,0,-8
17217,1,1,263,1378,1115
17218,0,0,26,0,-26
17219,1,1,184,1216,1032
17220,1,1,677,1284,607
17221,0,0,18,0,-18
17222,0,0,26,0,-26
17223,0,0,92,0,-92
17224,0,0,4,0,-4
17225,1,0,168,0,-168
17226,1,1,407,1863,1456
17227,1,0,0,0,0
17228,0,0,50,0,-50
17229,0,0,193,0,-193
17230,0,0,75,0,-75
17231,1,1,94,1334,1240
17232,0,0,1,0,-1
17233,0,0,27,0,-27
17234,0,0,83,0,-83
17235,1,0,27,0,-27
17236,0,0,52,0,-52
17237,1,0,15,0,-15
17238,0,0,24,0,-24
17239,1,0,46,0,-46
17240,1,0,0,0,0
17241,1,0,100,0,-100
17242,1,1,88,1444,1356
17243,0,0,20,0,-20
17244,1,1,1928,1296,-632
17245,0,0,42,0,-42
17246,1,0,37,0,-37
17247,1,1,2426,3837,1411
17248,1,1,175,1527,1352
17249,0,0,27,0,-27
17250,0,0,5,0,-5
17251,1,0,7,0,-7
17252,0,0,91,0,-91
17253,1,0,130,0,-130
17254,1,1,789,1302,513
17255,1,0,51,0,-51
17256,0,0,33,0,-33
17257,0,0,71,0,-71
17258,0,0,26,0,-26
17259,1,1,190,1256,1066
17260,0,0,46,0,-46
17261,1,1,211,1210,999
17262,1,1,592,1429,837
17263,1,0,5,0,-5
17264,0,0,122,0,-122
17265,0,0,12,0,-12
17266,1,1,279,1208,929
17267,0,0,184,0,-184
17268,1,1,281,1233,952
17269,1,0,199,0,-199
17270,1,0,13,0,-13
17271,1,1,251,1858,1607
17272,0,0,131,0,-131
17273,1,1,695,2085,1390
17274,1,1,1267,1242,-25
17275,0,0,14,0,-14
17276,1,1,260,1350,1090
17277,1,0,72,0,-72
17278,0,0,11,0,-11
17279,1,1,1747,1440,-307
17280,0,0,79,0,-79
17281,1,0,52,0,-52
17282,1,0,115,0,-115
17283,1,1,192,1240,1048
17284,1,0,21,0,-21
17285,0,0,20,0,-20
17286,0,0,22,0,-22
17287,0,0,41,0,-41
17288,1,0,17,0,-17
17289,1,1,156,1934,1778
17290,1,1,378,1208,830
17291,1,0,48,0,-48
17292,0,0,27,0,-27
17293,1,1,542,2164,1622
17294,1,0,0,0,0
17295,0,0,40,0,-40
17296,1,1,106,1378,1272
17297,0,0,46,0,-46
17298,1,0,41,0,-41
17299,1,0,29,0,-29
17300,0,0,30,0,-30
17301,1,0,5,0,-5
17302,0,0,56,0,-56
17303,1,0,136,0,-136
17304,0,0,108,0,-108
17305,1,1,127,1951,1824
17306,1,0,68,0,-68
17307,1,1,287,2061,1774
17308,1,0,17,0,-17
17309,1,1,141,1310,1169
17310,1,0,174,0,-174
17311,1,1,42,2485,2443
17312,1,0,30,0,-30
17313,0,0,10,0,-10
17314,0,0,51,0,-51
17315,0,0,210,0,-210
17316,1,1,113,1273,1160
17317,0,0,17,0,-17
17318,1,0,32,0,-32
17319,1,0,14,0,-14
17320,1,0,21,0,-21
17321,0,0,43,0,-43
17322,1,1,23,1343,1320
17323,0,0,81,0,-81
17324,1,1,287,1378,1091
17325,1,0,29,0,-29
17326,0,0,20,0,-20
17327,0,0,17,0,-17
17328,1,0,70,0,-70
17329,1,0,26,0,-26
17330,0,0,20,0,-20
17331,1,0,37,0,-37
17332,1,1,165,1565,1400
17333,0,0,5,0,-5
17334,0,0,342,0,-342
17335,1,1,129,1283,1154
17336,1,1,166,1376,1210
17337,0,0,26,0,-26
17338,0,0,14,0,-14
17339,0,0,69,0,-69
17340,1,1,17,2079,2062
17341,0,0,47,0,-47
17342,0,0,19,0,-19
17343,1,1,549,1597,1048
17344,1,0,161,0,-161
17345,0,0,40,0,-40
17346,0,0,16,0,-16
17347,0,0,14,0,-14
17348,1,1,2084,2018,-66
17349,0,0,54,0,-54
17350,1,1,188,1637,1449
17351,1,0,33,0,-33
17352,1,1,963,1879,916
17353,0,0,1,0,-1
17354,1,0,1,0,-1
17355,1,1,147,2436,2289
17356,0,0,121,0,-121
17357,1,0,12,0,-12
17358,0,0,20,0,-20
17359,1,1,293,1347,1054
17360,0,0,38,0,-38
17361,0,0,9,0,-9
17362,1,0,34,0,-34
17363,1,1,572,1308,736
17364,0,0,105,0,-105
17365,0,0,20,0,-20
17366,1,1,253,1683,1430
17367,1,1,191,2509,2318
17368,1,1,40,1662,1622
17369,1,0,67,0,-67
17370,1,0,4,0,-4
17371,0,0,3,0,-3
17372,1,0,36,0,-36
17373,0,0,8,0,-8
17374,1,0,62,0,-62
17375,1,1,313,1612,1299
17376,1,0,53,0,-53
17377,1,0,42,0,-42
17378,1,0,1,0,-1
17379,0,0,107,0,-107
17380,1,0,60,0,-60
17381,1,0,18,0,-18
17382,0,0,3,0,-3
17383,0,0,111,0,-111
17384,0,0,9,0,-9
17385,1,0,200,0,-200
17386,0,0,16,0,-16
17387,1,0,22,0,-22
17388,1,1,208,2684,2476
17389,1,0,7,0,-7
17390,0,0,48,0,-48
17391,1,1,137,1998,1861
17392,1,1,700,1202,502
17393,1,1,332,1527,1195
17394,1,1,100,1568,1468
17395,0,0,126,0,-126
17396,0,0,50,0,-50
17397,1,1,443,1331,888
17398,1,1,385,1554,1169
17399,0,0,11,0,-11
17400,1,1,263,1264,1001
17401,1,0,122,0,-122
17402,1,1,561,1880,1319
17403,1,0,47,0,-47
17404,1,1,724,1725,1001
17405,0,0,2,0,-2
17406,1,0,49,0,-49
17407,1,0,45,0,-45
17408,1,0,23,0,-23
17409,1,0,0,0,0
17410,1,0,257,0,-257
17411,1,0,21,0,-21
17412,1,1,131,1235,1104
17413,1,0,15,0,-15
17414,1,1,165,1276,1111
17415,1,0,4,0,-4
17416,0,0,10,0,-10
17417,1,1,773,2158,1385
17418,1,0,34,0,-34
17419,1,1,1020,1392,372
17420,1,1,513,1355,842
17421,0,0,31,0,-31
17422,1,1,245,1777,1532
17423,1,1,422,1630,1208
17424,1,0,9,0,-9
17425,0,0,11,0,-11
17426,1,0,62,0,-62
17427,1,1,464,1791,1327
17428,0,0,21,0,-21
17429,0,0,26,0,-26
17430,0,0,127,0,-127
17431,1,0,6,0,-6
17432,0,0,267,0,-267
17433,1,1,441,1695,1254
17434,1,0,40,0,-40
17435,1,1,34,1234,1200
17436,1,1,919,1491,572
17437,1,1,486,2031,1545
17438,0,0,22,0,-22
17439,1,0,80,0,-80
17440,0,0,5,0,-5
17441,1,1,661,1204,543
17442,0,0,30,0,-30
17443,0,0,10,0,-10
17444,0,0,162,0,-162
17445,0,0,177,0,-177
17446,0,0,86,0,-86
17447,0,0,38,0,-38
17448,1,1,135,1470,1335
17449,1,0,175,0,-175
17450,1,1,53,2042,1989
17451,0,0,8,0,-8
17452,1,1,1375,1254,-121
17453,1,1,288,1235,947
17454,1,0,5,0,-5
17455,0,0,22,0,-22
17456,1,0,11,0,-11
17457,1,1,505,1578,1073
17458,0,0,57,0,-57
17459,1,1,1024,1293,269
17460,0,0,48,0,-48
17461,1,0,132,0,-132
17462,0,0,8,0,-8
17463,0,0,37,0,-37
17464,1,0,22,0,-22
17465,0,0,9,0,-9
17466,0,0,6,0,-6
17467,1,1,819,1303,484
17468,1,1,91,1307,1216
17469,1,1,545,1778,1233
17470,1,1,682,1433,751
17471,1,1,207,1387,1180
17472,1,0,5,0,-5
17473,0,0,0,0,0
17474,1,1,177,1333,1156
17475,1,1,259,1648,1389
17476,1,0,5,0,-5
17477,1,0,9,0,-9
17478,0,0,4,0,-4
17479,1,0,3,0,-3
17480,0,0,60,0,-60
17481,0,0,195,0,-195
17482,1,1,339,1431,1092
17483,0,0,18,0,-18
17484,1,1,302,5693,5391
17485,1,1,853,1640,787
17486,1,1,97,1490,1393
17487,1,1,730,1461,731
17488,0,0,128,0,-128
17489,1,1,601,1230,629
17490,1,1,682,1445,763
17491,0,0,108,0,-108
17492,1,1,109,1529,1420
17493,0,0,56,0,-56
17494,1,0,87,0,-87
17495,1,1,283,1227,944
17496,1,1,705,1252,547
17497,0,0,1,0,-1
17498,1,0,41,0,-41
17499,1,0,15,0,-15
17500,0,0,42,0,-42
17501,1,1,1296,1575,279
17502,1,1,232,1309,1077
17503,0,0,71,0,-71
17504,1,1,97,1480,1383
17505,1,0,42,0,-42
17506,0,0,1,0,-1
17507,1,1,268,1266,998
17508,1,0,103,0,-103
17509,0,0,6,0,-6
17510,0,0,29,0,-29
17511,0,0,20,0,-20
17512,1,1,213,1244,1031
17513,1,0,140,0,-140
17514,1,0,76,0,-76
17515,0,0,28,0,-28
17516,1,0,51,0,-51
17517,1,1,272,1699,1427
17518,1,0,52,0,-52
17519,1,1,134,1372,1238
17520,0,0,77,0,-77
17521,0,0,3,0,-3
17522,1,0,130,0,-130
17523,1,0,185,0,-185
17524,0,0,1,0,-1
17525,0,0,175,0,-175
17526,1,0,15,0,-15
17527,1,0,31,0,-31
17528,1,1,421,1367,946
17529,1,1,444,1568,1124
17530,1,0,35,0,-35
17531,1,1,262,1287,1025
17532,1,0,114,0,-114
17533,1,0,89,0,-89
17534,0,0,31,0,-31
17535,1,1,1054,1842,788
17536,1,0,29,0,-29
17537,0,0,43,0,-43
17538,0,0,3,0,-3
17539,0,0,22,0,-22
17540,0,0,73,0,-73
17541,0,0,49,0,-49
17542,0,0,19,0,-19
17543,0,0,3,0,-3
17544,1,0,60,0,-60
17545,1,1,253,1263,1010
17546,1,0,9,0,-9
17547,0,0,111,0,-111
17548,0,0,7,0,-7
17549,1,1,106,3187,3081
17550,1,0,3,0,-3
17551,1,1,170,1449,1279
17552,0,0,17,0,-17
17553,0,0,77,0,-77
17554,1,0,117,0,-117
17555,1,1,1166,1233,67
17556,0,0,2,0,-2
17557,1,1,696,1337,641
17558,1,1,579,1218,639
17559,1,0,18,0,-18
17560,0,0,1,0,-1
17561,1,0,12,0,-12
17562,0,0,14,0,-14
17563,1,0,31,0,-31
17564,0,0,114,0,-114
17565,1,1,42,1247,1205
17566,0,0,32,0,-32
17567,1,0,8,0,-8
17568,1,1,82,1286,1204
17569,0,0,126,0,-126
17570,0,0,211,0,-211
17571,0,0,59,0,-59
17572,0,0,34,0,-34
17573,0,0,96,0,-96
17574,1,1,801,1553,752
17575,1,0,70,0,-70
17576,1,0,43,0,-43
17577,1,1,218,1439,1221
17578,1,1,38,1839,1801
17579,0,0,14,0,-14
17580,0,0,43,0,-43
17581,1,0,56,0,-56
17582,1,0,28,0,-28
17583,1,0,32,0,-32
17584,1,1,586,1699,1113
17585,1,1,558,1371,813
17586,1,0,56,0,-56
17587,1,0,30,0,-30
17588,0,0,16,0,-16
17589,0,0,21,0,-21
17590,1,1,631,1215,584
17591,0,0,96,0,-96
17592,0,0,0,0,0
17593,1,1,226,1444,1218
17594,1,0,38,0,-38
17595,0,0,26,0,-26
17596,1,1,382,1314,932
17597,0,0,16,0,-16
17598,1,1,884,1301,417
17599,1,0,0,0,0
17600,0,0,122,0,-122
17601,1,1,29,1241,1212
17602,1,1,102,1229,1127
17603,1,1,499,1381,882
17604,1,1,206,1232,1026
17605,1,0,55,0,-55
17606,1,0,13,0,-13
17607,1,0,5,0,-5
17608,1,1,61,1350,1289
17609,1,1,1816,1280,-536
17610,1,1,476,1238,762
17611,1,0,5,0,-5
17612,1,1,1382,1448,66
17613,1,1,1131,1323,192
17614,0,0,64,0,-64
17615,1,1,348,1312,964
17616,1,1,242,3086,2844
17617,1,0,10,0,-10
17618,1,1,650,1561,911
17619,1,0,87,0,-87
17620,1,1,194,1456,1262
17621,1,1,24,1778,1754
17622,0,0,76,0,-76
17623,1,0,76,0,-76
17624,0,0,45,0,-45
17625,0,0,26,0,-26
17626,0,0,68,0,-68
17627,1,0,2,0,-2
17628,1,0,53,0,-53
17629,0,0,51,0,-51
17630,1,1,1058,2812,1754
17631,1,1,273,1200,927
17632,1,1,44,1886,1842
17633,0,0,37,0,-37
17634,1,0,140,0,-140
17635,0,0,25,0,-25
17636,0,0,62,0,-62
17637,0,0,38,0,-38
17638,1,1,375,1260,885
17639,0,0,46,0,-46
17640,0,0,12,0,-12
17641,1,0,36,0,-36
17642,0,0,17,0,-17
17643,0,0,20,0,-20
17644,0,0,79,0,-79
17645,1,1,54,1513,1459
17646,1,1,212,1244,1032
17647,0,0,60,0,-60
17648,0,0,6,0,-6
17649,1,1,283,2836,2553
17650,0,0,9,0,-9
17651,1,0,45,0,-45
17652,0,0,26,0,-26
17653,0,0,49,0,-49
17654,0,0,31,0,-31
17655,0,0,11,0,-11
17656,0,0,112,0,-112
17657,0,0,55,0,-55
17658,1,1,236,1261,1025
17659,1,1,798,1993,1195
17660,1,1,801,1477,676
17661,0,0,2,0,-2
17662,1,1,812,1455,643
17663,1,1,57,1542,1485
17664,1,0,32,0,-32
17665,0,0,187,0,-187
17666,0,0,82,0,-82
17667,1,1,155,1624,1469
17668,1,0,36,0,-36
17669,0,0,16,0,-16
17670,1,0,11,0,-11
17671,0,0,23,0,-23
17672,1,1,137,1618,1481
17673,1,1,146,1246,1100
17674,1,0,172,0,-172
17675,1,0,113,0,-113
17676,1,1,408,1440,1032
17677,1,1,1140,1289,149
17678,0,0,3,0,-3
17679,1,0,42,0,-42
17680,0,0,53,0,-53
17681,1,0,1,0,-1
17682,0,0,1,0,-1
17683,0,0,57,0,-57
17684,1,1,550,1380,830
17685,1,0,52,0,-52
17686,1,0,34,0,-34
17687,1,0,13,0,-13
17688,1,0,28,0,-28
17689,1,0,5,0,-5
17690,0,0,7,0,-7
17691,0,0,15,0,-15
17692,1,1,219,1944,1725
17693,0,0,95,0,-95
17694,0,0,3,0,-3
17695,1,0,37,0,-37
17696,0,0,23,0,-23
17697,0,0,119,0,-119
17698,0,0,114,0,-114
17699,1,0,52,0,-52
17700,1,0,89,0,-89
17701,1,0,1,0,-1
17702,0,0,6,0,-6
17703,0,0,11,0,-11
17704,0,0,36,0,-36
17705,1,0,36,0,-36
17706,1,0,66,0,-66
17707,1,0,17,0,-17
17708,1,1,215,1551,1336
17709,1,1,254,1275,1021
17710,0,0,4,0,-4
17711,1,0,3,0,-3
17712,0,0,46,0,-46
17713,1,1,348,1643,1295
17714,0,0,2,0,-2
17715,1,1,174,1654,1480
17716,1,1,531,1273,742
17717,1,0,5,0,-5
17718,0,0,17,0,-17
17719,1,0,3,0,-3
17720,1,0,42,0,-42
17721,1,0,26,0,-26
17722,0,0,0,0,0
17723,1,0,124,0,-124
17724,1,1,697,1495,798
17725,1,1,579,1540,961
17726,0,0,105,0,-105
17727,1,1,1475,1203,-272
17728,1,1,321,1480,1159
17729,1,0,130,0,-130
17730,1,0,17,0,-17
17731,0,0,7,0,-7
17732,0,0,128,0,-128
17733,1,0,28,0,-28
17734,1,1,1034,1383,349
17735,1,1,423,1359,936
17736,0,0,9,0,-9
17737,1,1,68,1351,1283
17738,1,1,594,1481,887
17739,1,0,34,0,-34
17740,1,0,7,0,-7
17741,1,0,42,0,-42
17742,1,0,98,0,-98
17743,0,0,5,0,-5
17744,1,0,22,0,-22
17745,1,1,94,1238,1144
17746,1,1,516,2334,1818
17747,0,0,14,0,-14
17748,1,0,27,0,-27
17749,0,0,79,0,-79
17750,1,0,27,0,-27
17751,0,0,30,0,-30
17752,1,1,1165,1827,662
17753,1,1,739,1581,842
17754,0,0,151,0,-151
17755,1,1,221,1460,1239
17756,1,1,424,1202,778
17757,0,0,18,0,-18
17758,1,0,12,0,-12
17759,1,1,217,1439,1222
17760,1,0,56,0,-56
17761,0,0,42,0,-42
17762,0,0,53,0,-53
17763,1,0,131,0,-131
17764,1,1,105,2950,2845
17765,1,1,887,1238,351
17766,1,0,153,0,-153
17767,0,0,47,0,-47
17768,1,1,185,1247,1062
17769,1,0,0,0,0
17770,1,0,10,0,-10
17771,1,1,957,2043,1086
17772,1,0,50,0,-50
17773,1,0,29,0,-29
17774,1,1,1315,1565,250
17775,0,0,54,0,-54
17776,1,1,530,1336,806
17777,0,0,15,0,-15
17778,1,0,0,0,0
17779,1,1,95,1910,1815
17780,1,0,36,0,-36
17781,1,1,319,1248,929
17782,1,1,338,1412,1074
17783,1,0,119,0,-119
17784,0,0,105,0,-105
17785,0,0,101,0,-101
17786,0,0,59,0,-59
17787,0,0,31,0,-31
17788,0,0,137,0,-137
17789,1,1,1649,1318,-331
17790,1,0,41,0,-41
17791,0,0,2,0,-2
17792,0,0,9,0,-9
17793,0,0,3,0,-3
17794,0,0,9,0,-9
17795,1,1,782,1360,578
17796,0,0,101,0,-101
17797,0,0,82,0,-82
17798,0,0,18,0,-18
17799,0,0,92,0,-92
17800,0,0,44,0,-44
17801,0,0,26,0,-26
17802,0,0,3,0,-3
17803,1,0,57,0,-57
17804,0,0,5,0,-5
17805,1,0,74,0,-74
17806,1,1,494,2204,1710
17807,0,0,46,0,-46
17808,0,0,10,0,-10
17809,1,1,220,1781,1561
17810,1,1,801,2059,1258
17811,1,1,409,1351,942
17812,0,0,12,0,-12
17813,1,0,9,0,-9
17814,1,1,35,1218,1183
17815,0,0,22,0,-22
17816,1,0,52,0,-52
17817,1,1,165,1505,1340
17818,0,0,61,0,-61
17819,1,0,62,0,-62
17820,0,0,43,0,-43
17821,1,1,629,1225,596
17822,1,1,214,1496,1282
17823,1,1,671,1416,745
17824,0,0,10,0,-10
17825,1,0,12,0,-12
17826,0,0,77,0,-77
17827,0,0,19,0,-19
17828,1,0,79,0,-79
17829,1,0,26,0,-26
17830,0,0,50,0,-50
17831,1,1,1541,1501,-40
17832,1,0,29,0,-29
17833,1,0,51,0,-51
17834,1,0,44,0,-44
17835,0,0,104,0,-104
17836,1,1,370,1511,1141
17837,1,0,79,0,-79
17838,1,0,4,0,-4
17839,0,0,31,0,-31
17840,0,0,16,0,-16
17841,0,0,115,0,-115
17842,1,0,89,0,-89
17843,0,0,119,0,-119
17844,1,1,189,1561,1372
17845,1,0,25,0,-25
17846,0,0,37,0,-37
17847,1,1,506,1775,1269
17848,0,0,8,0,-8
17849,0,0,102,0,-102
17850,0,0,55,0,-55
17851,0,0,67,0,-67
17852,0,0,26,0,-26
17853,1,1,104,1251,1147
17854,0,0,59,0,-59
17855,1,1,451,1341,890
17856,1,0,58,0,-58
17857,1,0,228,0,-228
17858,0,0,86,0,-86
17859,1,0,93,0,-93
17860,1,0,50,0,-50
17861,1,0,6,0,-6
17862,0,0,1,0,-1
17863,0,0,59,0,-59
17864,0,0,52,0,-52
17865,0,0,98,0,-98
17866,0,0,3,0,-3
17867,0,0,22,0,-22
17868,1,1,630,1808,1178
17869,1,1,1337,1741,404
17870,0,0,9,0,-9
17871,1,0,9,0,-9
17872,1,0,38,0,-38
17873,1,0,9,0,-9
17874,0,0,54,0,-54
17875,1,0,40,0,-40
17876,1,0,11,0,-11
17877,1,1,162,2334,2172
17878,1,1,770,1415,645
17879,1,1,10,1718,1708
17880,0,0,41,0,-41
17881,1,0,143,0,-143
17882,1,1,322,2198,1876
17883,1,1,1432,1215,-217
17884,1,1,632,3410,2778
17885,0,0,93,0,-93
17886,1,1,421,1465,1044
17887,0,0,33,0,-33
17888,0,0,36,0,-36
17889,1,1,667,1382,715
17890,1,0,12,0,-12
17891,0,0,20,0,-20
17892,1,0,160,0,-160
17893,1,1,258,1205,947
17894,0,0,4,0,-4
17895,1,0,9,0,-9
17896,1,1,531,1281,750
17897,1,1,23,1211,1188
17898,1,1,300,1241,941
17899,0,0,8,0,-8
17900,1,1,594,1566,972
17901,0,0,1,0,-1
17902,0,0,12,0,-12
17903,1,0,66,0,-66
17904,1,0,35,0,-35
17905,1,0,45,0,-45
17906,1,0,57,0,-57
17907,1,1,176,1207,1031
17908,0,0,16,0,-16
17909,0,0,13,0,-13
17910,0,0,136,0,-136
17911,0,0,33,0,-33
17912,1,1,388,1273,885
17913,1,1,44,1238,1194
17914,0,0,125,0,-125
17915,1,1,1376,1312,-64
17916,1,1,442,1225,783
17917,0,0,107,0,-107
17918,1,0,3,0,-3
17919,0,0,90,0,-90
17920,1,1,566,2011,1445
17921,1,0,36,0,-36
17922,1,0,42,0,-42
17923,0,0,33,0,-33
17924,1,0,30,0,-30
17925,1,1,337,1218,881
17926,1,1,590,1200,610
17927,1,1,6,1378,1372
17928,1,0,55,0,-55
17929,1,0,54,0,-54
17930,1,0,3,0,-3
17931,1,0,32,0,-32
17932,1,1,114,1515,1401
17933,1,0,5,0,-5
17934,0,0,19,0,-19
17935,1,0,57,0,-57
17936,0,0,19,0,-19
17937,1,0,7,0,-7
17938,1,1,559,1240,681
17939,1,0,82,0,-82
17940,1,0,35,0,-35
17941,1,1,597,1514,917
17942,0,0,75,0,-75
17943,1,0,7,0,-7
17944,1,1,356,1271,915
17945,0,0,12,0,-12
17946,0,0,17,0,-17
17947,0,0,10,0,-10
17948,0,0,41,0,-41
17949,1,0,26,0,-26
17950,1,1,111,1285,1174
17951,0,0,101,0,-101
17952,1,1,1431,1291,-140
17953,1,0,56,0,-56
17954,1,1,473,1736,1263
17955,1,0,84,0,-84
17956,1,1,710,1223,513
17957,1,0,41,0,-41
17958,0,0,43,0,-43
17959,1,1,1369,1220,-149
17960,1,1,151,1622,1471
17961,1,0,185,0,-185
17962,0,0,147,0,-147
17963,0,0,54,0,-54
17964,0,0,54,0,-54
17965,1,1,984,1311,327
17966,0,0,61,0,-61
17967,1,0,200,0,-200
17968,1,0,13,0,-13
17969,1,1,156,1699,1543
17970,0,0,101,0,-101
17971,1,1,705,1410,705
17972,1,0,9,0,-9
17973,0,0,10,0,-10
17974,0,0,10,0,-10
17975,0,0,156,0,-156
17976,1,0,21,0,-21
17977,1,1,156,1367,1211
17978,1,0,87,0,-87
17979,0,0,35,0,-35
17980,1,1,210,1213,1003
17981,1,0,101,0,-101
17982,1,0,3,0,-3
17983,1,1,110,1227,1117
17984,0,0,13,0,-13
17985,1,0,44,0,-44
17986,1,1,623,1420,797
17987,1,1,1561,1216,-345
17988,0,0,14,0,-14
17989,1,0,44,0,-44
17990,1,0,35,0,-35
17991,0,0,129,0,-129
17992,1,1,1378,1540,162
17993,0,0,53,0,-53
17994,1,0,2,0,-2
17995,1,0,47,0,-47
17996,1,0,61,0,-61
17997,1,1,683,1574,891
17998,0,0,49,0,-49
17999,1,1,220,1802,1582
18000,0,0,19,0,-19
18001,1,1,86,1312,1226
18002,0,0,81,0,-81
18003,1,1,223,1327,1104
18004,1,1,38,2003,1965
18005,1,0,21,0,-21
18006,0,0,30,0,-30
18007,0,0,25,0,-25
18008,1,0,41,0,-41
18009,1,0,28,0,-28
18010,0,0,8,0,-8
18011,1,0,90,0,-90
18012,1,1,435,2238,1803
18013,1,0,22,0,-22
18014,1,1,94,1369,1275
18015,1,0,16,0,-16
18016,1,0,5,0,-5
18017,0,0,16,0,-16
18018,0,0,2,0,-2
18019,1,1,130,1236,1106
18020,1,1,212,1239,1027
18021,1,1,272,1904,1632
18022,1,1,456,1326,870
18023,1,0,36,0,-36
18024,1,1,198,1256,1058
18025,0,0,20,0,-20
18026,1,1,216,1399,1183
18027,0,0,53,0,-53
18028,0,0,2,0,-2
18029,0,0,11,0,-11
18030,0,0,18,0,-18
18031,1,0,27,0,-27
18032,1,0,59,0,-59
18033,0,0,20,0,-20
18034,0,0,8,0,-8
18035,1,0,16,0,-16
18036,1,0,22,0,-22
18037,1,0,10,0,-10
18038,1,1,177,1284,1107
18039,1,1,338,1880,1542
18040,0,0,198,0,-198
18041,0,0,14,0,-14
18042,0,0,5,0,-5
18043,1,1,554,1386,832
18044,0,0,0,0,0
18045,1,1,79,1561,1482
18046,0,0,26,0,-26
18047,0,0,1,0,-1
18048,0,0,6,0,-6
18049,1,1,431,1561,1130
18050,1,1,116,1665,1549
18051,0,0,35,0,-35
18052,1,1,627,1356,729
18053,1,1,45,1823,1778
18054,0,0,16,0,-16
18055,1,1,429,1229,800
18056,1,1,86,1315,1229
18057,0,0,10,0,-10
18058,0,0,59,0,-59
18059,1,1,1249,1327,78
18060,0,0,3,0,-3
18061,1,1,362,1579,1217
18062,1,0,10,0,-10
18063,1,1,979,1414,435
18064,1,0,123,0,-123
18065,0,0,1,0,-1
18066,0,0,11,0,-11
18067,1,0,25,0,-25
18068,1,0,220,0,-220
18069,1,1,70,1862,1792
18070,1,0,40,0,-40
18071,1,0,33,0,-33
18072,0,0,10,0,-10
18073,1,1,279,1685,1406
18074,0,0,119,0,-119
18075,0,0,5,0,-5
18076,1,1,989,1668,679
18077,1,0,52,0,-52
18078,1,0,21,0,-21
18079,1,1,732,1213,481
18080,0,0,9,0,-9
18081,0,0,25,0,-25
18082,1,0,12,0,-12
18083,1,1,566,1325,759
18084,1,0,10,0,-10
18085,1,0,57,0,-57
18086,1,1,521,1281,760
18087,0,0,98,0,-98
18088,1,1,229,1287,1058
18089,1,1,375,1751,1376
18090,0,0,59,0,-59
18091,0,0,138,0,-138
18092,0,0,62,0,-62
18093,0,0,27,0,-27
18094,1,1,210,1271,1061
18095,1,0,11,0,-11
18096,1,1,954,1891,937
18097,1,0,9,0,-9
18098,1,1,169,1241,1072
18099,1,1,568,1466,898
18100,0,0,3,0,-3
18101,1,1,74,1307,1233
18102,0,0,31,0,-31
18103,1,1,273,1870,1597
18104,1,0,69,0,-69
18105,1,1,36,2328,2292
18106,1,1,1331,2586,1255
18107,1,0,1,0,-1
18108,0,0,48,0,-48
18109,1,0,38,0,-38
18110,0,0,37,0,-37
18111,1,1,146,2471,2325
18112,1,0,30,0,-30
18113,1,1,235,3756,3521
18114,0,0,82,0,-82
18115,1,0,141,0,-141
18116,0,0,9,0,-9
18117,0,0,22,0,-22
18118,0,0,65,0,-65
18119,0,0,24,0,-24
18120,0,0,73,0,-73
18121,1,1,759,1318,559
18122,1,1,1476,1499,23
18123,0,0,63,0,-63
18124,0,0,34,0,-34
18125,0,0,21,0,-21
18126,1,1,1183,2104,921
18127,0,0,51,0,-51
18128,0,0,28,0,-28
18129,1,1,290,1483,1193
18130,0,0,59,0,-59
18131,0,0,31,0,-31
18132,0,0,42,0,-42
18133,0,0,62,0,-62
18134,0,0,18,0,-18
18135,0,0,27,0,-27
18136,1,1,469,1207,738
18137,0,0,13,0,-13
18138,1,0,72,0,-72
18139,0,0,26,0,-26
18140,1,0,1,0,-1
18141,1,0,17,0,-17
18142,0,0,2,0,-2
18143,1,1,66,1712,1646
18144,1,1,81,3355,3274
18145,0,0,156,0,-156
18146,1,1,155,1244,1089
18147,0,0,49,0,-49
18148,1,0,87,0,-87
18149,1,0,144,0,-144
18150,1,0,63,0,-63
18151,1,1,171,1564,1393
18152,1,1,558,1310,752
18153,1,1,298,2095,1797
18154,0,0,10,0,-10
18155,1,1,664,2290,1626
18156,1,0,1,0,-1
18157,0,0,53,0,-53
18158,1,1,772,1522,750
18159,1,0,52,0,-52
18160,0,0,6,0,-6
18161,1,1,195,2266,2071
18162,0,0,14,0,-14
18163,0,0,37,0,-37
18164,1,1,695,1248,553
18165,1,1,473,1251,778
18166,0,0,5,0,-5
18167,1,0,93,0,-93
18168,1,0,57,0,-57
18169,1,0,154,0,-154
18170,1,1,382,1460,1078
18171,1,1,203,1894,1691
18172,0,0,44,0,-44
18173,0,0,40,0,-40
18174,0,0,1,0,-1
18175,1,0,25,0,-25
18176,1,0,19,0,-19
18177,0,0,28,0,-28
18178,1,0,236,0,-236
18179,0,0,62,0,-62
18180,0,0,74,0,-74
18181,1,1,1039,1567,528
18182,1,0,78,0,-78
18183,1,1,972,1263,291
18184,1,1,575,1293,718
18185,0,0,12,0,-12
18186,0,0,116,0,-116
18187,1,1,305,1285,980
18188,0,0,13,0,-13
18189,1,1,429,3682,3253
18190,1,1,2088,1766,-322
18191,0,0,2,0,-2
18192,1,1,613,1544,931
18193,1,1,94,1226,1132
18194,1,0,18,0,-18
18195,1,0,22,0,-22
18196,1,0,103,0,-103
18197,1,1,544,1844,1300
18198,0,0,15,0,-15
18199,1,0,48,0,-48
18200,0,0,24,0,-24
18201,0,0,15,0,-15
18202,0,0,0,0,0
18203,0,0,5,0,-5
18204,1,0,1,0,-1
18205,0,0,0,0,0
18206,0,0,16,0,-16
18207,1,0,4,0,-4
18208,1,0,37,0,-37
18209,0,0,36,0,-36
18210,1,0,20,0,-20
18211,1,0,65,0,-65
18212,1,0,10,0,-10
18213,1,0,50,0,-50
18214,0,0,51,0,-51
18215,1,1,446,1619,1173
18216,0,0,14,0,-14
18217,1,1,790,1976,1186
18218,0,0,57,0,-57
18219,1,0,2,0,-2
18220,0,0,38,0,-38
18221,0,0,3,0,-3
18222,0,0,4,0,-4
18223,1,1,1469,1256,-213
18224,1,1,1031,2360,1329
18225,1,1,567,1267,700
18226,1,1,766,1872,1106
18227,1,0,42,0,-42
18228,0,0,146,0,-146
18229,1,0,63,0,-63
18230,1,1,291,1626,1335
18231,1,0,134,0,-134
18232,1,0,15,0,-15
18233,1,1,197,1475,1278
18234,1,0,7,0,-7
18235,1,0,69,0,-69
18236,1,0,26,0,-26
18237,1,1,196,1344,1148
18238,1,0,58,0,-58
18239,0,0,52,0,-52
18240,1,1,483,1278,795
18241,1,0,41,0,-41
18242,1,0,58,0,-58
18243,1,1,969,2599,1630
18244,0,0,82,0,-82
18245,1,0,32,0,-32
18246,1,1,992,2246,1254
18247,0,0,6,0,-6
18248,1,1,2095,1659,-436
18249,1,1,83,1866,1783
18250,1,1,351,1367,1016
18251,1,1,673,1283,610
18252,1,1,335,1271,936
18253,1,1,389,1844,1455
18254,0,0,31,0,-31
18255,1,1,27,1460,1433
18256,1,0,2,0,-2
18257,1,0,3,0,-3
18258,1,1,209,1204,995
18259,1,0,220,0,-220
18260,1,1,303,1205,902
18261,1,0,69,0,-69
18262,0,0,3,0,-3
18263,1,1,628,1301,673
18264,0,0,28,0,-28
18265,1,0,134,0,-134
18266,1,0,7,0,-7
18267,1,1,332,1292,960
18268,0,0,62,0,-62
18269,1,1,56,2820,2764
18270,1,1,44,1273,1229
18271,1,0,120,0,-120
18272,1,1,32,1317,1285
18273,1,0,9,0,-9
18274,0,0,152,0,-152
18275,1,1,626,1496,870
18276,1,0,24,0,-24
18277,0,0,142,0,-142
18278,1,0,82,0,-82
18279,0,0,5,0,-5
18280,1,1,209,1831,1622
18281,1,0,63,0,-63
18282,1,1,270,1225,955
18283,1,0,7,0,-7
18284,1,0,24,0,-24
18285,0,0,57,0,-57
18286,1,0,97,0,-97
18287,1,0,10,0,-10
18288,0,0,54,0,-54
18289,0,0,13,0,-13
18290,0,0,42,0,-42
18291,0,0,182,0,-182
18292,1,1,1187,2658,1471
18293,1,1,679,1653,974
18294,1,1,392,1497,1105
18295,1,0,10,0,-10
18296,1,1,271,1511,1240
18297,1,0,0,0,0
18298,1,0,3,0,-3
18299,1,1,34,1214,1180
18300,0,0,16,0,-16
18301,1,0,59,0,-59
18302,0,0,15,0,-15
18303,0,0,67,0,-67
18304,0,0,14,0,-14
18305,1,0,16,0,-16
18306,1,1,100,1643,1543
18307,0,0,180,0,-180
18308,1,0,30,0,-30
18309,0,0,10,0,-10
18310,1,1,1095,1802,707
18311,0,0,43,0,-43
18312,1,0,45,0,-45
18313,1,1,167,1233,1066
18314,0,0,79,0,-79
18315,0,0,20,0,-20
18316,1,0,73,0,-73
18317,0,0,21,0,-21
18318,0,0,20,0,-20
18319,1,0,9,0,-9
18320,1,1,29,1469,1440
18321,1,1,418,3144,2726
18322,1,0,85,0,-85
18323,0,0,10,0,-10
18324,0,0,26,0,-26
18325,1,0,103,0,-103
18326,1,0,62,0,-62
18327,1,0,13,0,-13
18328,1,1,117,1230,1113
18329,1,1,259,1332,1073
18330,1,0,74,0,-74
18331,1,1,432,1450,1018
18332,1,0,146,0,-146
18333,1,0,3,0,-3
18334,1,1,332,1676,1344
18335,1,0,163,0,-163
18336,0,0,2,0,-2
18337,0,0,87,0,-87
18338,1,0,45,0,-45
18339,0,0,11,0,-11
18340,0,0,29,0,-29
18341,0,0,3,0,-3
18342,1,0,27,0,-27
18343,0,0,9,0,-9
18344,1,1,341,1545,1204
18345,0,0,228,0,-228
18346,1,1,591,2407,1816
18347,0,0,92,0,-92
18348,1,0,43,0,-43
18349,0,0,159,0,-159
18350,0,0,16,0,-16
18351,0,0,0,0,0
18352,1,1,929,1238,309
18353,1,0,19,0,-19
18354,1,0,36,0,-36
18355,1,0,28,0,-28
18356,1,0,26,0,-26
18357,0,0,31,0,-31
18358,1,1,1023,2007,984
18359,1,0,11,0,-11
18360,1,1,222,1266,1044
18361,0,0,72,0,-72
18362,0,0,131,0,-131
18363,1,0,59,0,-59
18364,1,0,55,0,-55
18365,0,0,7,0,-7
18366,0,0,78,0,-78
18367,1,1,709,1399,690
18368,1,0,7,0,-7
18369,1,1,505,1245,740
18370,1,1,1126,1585,459
18371,1,1,742,1378,636
18372,0,0,22,0,-22
18373,1,0,0,0,0
18374,1,1,114,1248,1134
18375,0,0,24,0,-24
18376,0,0,0,0,0
18377,1,0,38,0,-38
18378,1,1,865,1461,596
18379,1,0,69,0,-69
18380,1,1,186,1803,1617
18381,0,0,3,0,-3
18382,1,0,11,0,-11
18383,1,1,393,1459,1066
18384,1,1,108,1748,1640
18385,1,0,43,0,-43
18386,1,1,590,1222,632
18387,1,1,460,1508,1048
18388,1,1,569,1422,853
18389,0,0,52,0,-52
18390,0,0,33,0,-33
18391,0,0,6,0,-6
18392,1,0,37,0,-37
18393,0,0,23,0,-23
18394,0,0,69,0,-69
18395,0,0,32,0,-32
18396,0,0,46,0,-46
18397,1,1,225,1247,1022
18398,1,1,888,3250,2362
18399,1,0,170,0,-170
18400,1,0,54,0,-54
18401,1,1,235,2326,2091
18402,0,0,1,0,-1
18403,1,1,923,2332,1409
18404,1,1,255,1305,1050
18405,1,0,52,0,-52
18406,1,0,29,0,-29
18407,1,1,72,1236,1164
18408,1,0,84,0,-84
18409,1,1,1686,1258,-428
18410,1,1,933,1915,982
18411,1,1,360,1307,947
18412,0,0,7,0,-7
18413,0,0,39,0,-39
18414,0,0,76,0,-76
18415,1,0,50,0,-50
18416,0,0,26,0,-26
18417,0,0,58,0,-58
18418,1,1,87,2156,2069
18419,1,1,114,1374,1260
18420,1,0,103,0,-103
18421,1,0,36,0,-36
18422,1,1,16,1212,1196
18423,1,0,10,0,-10
18424,0,0,113,0,-113
18425,1,1,263,1353,1090
18426,1,0,26,0,-26
18427,0,0,13,0,-13
18428,0,0,146,0,-146
18429,0,0,3,0,-3
18430,1,1,244,1353,1109
18431,1,1,306,1502,1196
18432,0,0,48,0,-48
18433,0,0,87,0,-87
18434,1,1,745,1221,476
18435,0,0,20,0,-20
18436,1,1,480,1245,765
18437,0,0,120,0,-120
18438,1,1,297,1599,1302
18439,0,0,8,0,-8
18440,1,1,219,1468,1249
18441,0,0,54,0,-54
18442,0,0,2,0,-2
18443,0,0,31,0,-31
18444,1,1,163,1891,1728
18445,1,0,152,0,-152
18446,1,1,949,1209,260
18447,0,0,33,0,-33
18448,0,0,162,0,-162
18449,1,1,364,1664,1300
18450,0,0,6,0,-6
18451,1,0,55,0,-55
18452,1,1,335,1253,918
18453,0,0,12,0,-12
18454,1,0,1,0,-1
18455,0,0,1,0,-1
18456,0,0,3,0,-3
18457,0,0,3,0,-3
18458,0,0,165,0,-165
18459,1,1,32,1241,1209
18460,0,0,47,0,-47
18461,1,1,2373,1448,-925
18462,1,0,33,0,-33
18463,1,0,4,0,-4
18464,0,0,63,0,-63
18465,1,1,543,1779,1236
18466,0,0,78,0,-78
18467,1,0,163,0,-163
18468,1,0,28,0,-28
18469,1,1,195,1213,1018
18470,0,0,33,0,-33
18471,0,0,14,0,-14
18472,0,0,42,0,-42
18473,1,1,158,1603,1445
18474,0,0,84,0,-84
18475,1,1,169,2120,1951
18476,1,1,155,1440,1285
18477,1,1,118,2895,2777
18478,0,0,297,0,-297
18479,1,0,37,0,-37
18480,1,1,415,2122,1707
18481,0,0,37,0,-37
18482,1,1,548,1327,779
18483,0,0,27,0,-27
18484,1,0,33,0,-33
18485,0,0,5,0,-5
18486,0,0,4,0,-4
18487,1,1,141,1298,1157
18488,0,0,26,0,-26
18489,1,1,191,1234,1043
18490,1,0,56,0,-56
18491,0,0,100,0,-100
18492,1,0,48,0,-48
18493,1,1,227,1268,1041
18494,1,0,17,0,-17
18495,1,1,990,1356,366
18496,0,0,64,0,-64
18497,1,1,834,1613,779
18498,1,1,279,1618,1339
18499,1,1,683,1901,1218
18500,1,1,117,2060,1943
18501,0,0,47,0,-47
18502,1,1,38,1214,1176
18503,1,0,21,0,-21
18504,1,0,74,0,-74
18505,1,1,242,1308,1066
18506,0,0,119,0,-119
18507,0,0,100,0,-100
18508,1,0,1,0,-1
18509,0,0,7,0,-7
18510,1,0,87,0,-87
18511,1,0,129,0,-129
18512,1,1,714,1208,494
18513,1,1,222,1607,1385
18514,0,0,226,0,-226
18515,1,1,468,1845,1377
18516,0,0,41,0,-41
18517,0,0,7,0,-7
18518,1,1,675,1339,664
18519,0,0,0,0,0
18520,1,1,269,1254,985
18521,1,0,21,0,-21
18522,1,1,134,1579,1445
18523,0,0,50,0,-50
18524,1,1,447,1302,855
18525,1,0,27,0,-27
18526,1,1,409,1922,1513
18527,0,0,9,0,-9
18528,1,0,1,0,-1
18529,0,0,28,0,-28
18530,0,0,5,0,-5
18531,0,0,19,0,-19
18532,0,0,51,0,-51
18533,0,0,2,0,-2
18534,0,0,64,0,-64
18535,1,0,9,0,-9
18536,0,0,16,0,-16
18537,0,0,31,0,-31
18538,1,0,54,0,-54
18539,1,1,2031,1289,-742
18540,0,0,6,0,-6
18541,0,0,33,0,-33
18542,1,1,58,1353,1295
18543,1,0,9,0,-9
18544,1,1,286,1231,945
18545,1,0,130,0,-130
18546,0,0,54,0,-54
18547,1,1,110,1356,1246
18548,1,1,1343,1249,-94
18549,1,0,49,0,-49
18550,0,0,73,0,-73
18551,1,0,68,0,-68
18552,1,1,909,1328,419
18553,1,1,2751,1234,-1517
18554,1,0,108,0,-108
18555,0,0,50,0,-50
18556,1,0,48,0,-48
18557,0,0,34,0,-34
18558,1,1,197,1291,1094
18559,0,0,16,0,-16
18560,0,0,53,0,-53
18561,1,0,13,0,-13
18562,1,1,750,1337,587
18563,1,1,389,1266,877
18564,1,1,78,1295,1217
18565,1,0,28,0,-28
18566,1,1,232,1529,1297
18567,1,0,26,0,-26
18568,1,1,216,1334,1118
18569,0,0,169,0,-169
18570,0,0,124,0,-124
18571,0,0,44,0,-44
18572,1,1,317,1454,1137
18573,1,1,116,1445,1329
18574,1,1,820,1651,831
18575,1,1,952,2421,1469
18576,0,0,60,0,-60
18577,1,1,1267,1357,90
18578,0,0,89,0,-89
18579,1,0,7,0,-7
18580,0,0,22,0,-22
18581,0,0,103,0,-103
18582,1,0,11,0,-11
18583,0,0,8,0,-8
18584,1,1,711,1222,511
18585,1,1,743,1297,554
18586,1,0,13,0,-13
18587,1,1,155,1644,1489
18588,1,0,0,0,0
18589,1,1,65,1721,1656
18590,0,0,53,0,-53
18591,0,0,48,0,-48
18592,0,0,78,0,-78
18593,0,0,20,0,-20
18594,1,0,9,0,-9
18595,1,1,387,1206,819
18596,1,1,498,1538,1040
18597,1,1,726,1262,536
18598,0,0,109,0,-109
18599,1,1,715,1479,764
18600,1,1,1624,1264,-360
18601,1,1,991,1421,430
18602,0,0,94,0,-94
18603,1,0,1,0,-1
18604,0,0,81,0,-81
18605,0,0,8,0,-8
18606,1,0,131,0,-131
18607,0,0,63,0,-63
18608,0,0,39,0,-39
18609,1,0,51,0,-51
18610,1,1,517,2084,1567
18611,0,0,61,0,-61
18612,1,0,36,0,-36
18613,1,1,1183,1420,237
18614,1,1,776,1540,764
18615,0,0,129,0,-129
18616,0,0,52,0,-52
18617,0,0,95,0,-95
18618,1,0,19,0,-19
18619,0,0,140,0,-140
18620,0,0,66,0,-66
18621,1,0,17,0,-17
18622,1,0,41,0,-41
18623,0,0,7,0,-7
18624,1,0,121,0,-121
18625,1,1,226,2257,2031
18626,1,0,59,0,-59
18627,1,1,241,1292,1051
18628,1,0,3,0,-3
18629,1,0,0,0,0
18630,1,0,17,0,-17
18631,0,0,22,0,-22
18632,1,0,35,0,-35
18633,0,0,8,0,-8
18634,1,0,18,0,-18
18635,1,1,42,1766,1724
18636,1,1,204,3670,3466
18637,1,0,0,0,0
18638,1,1,185,1715,1530
18639,1,1,77,1314,1237
18640,0,0,125,0,-125
18641,1,0,50,0,-50
18642,0,0,81,0,-81
18643,1,0,171,0,-171
18644,0,0,39,0,-39
18645,0,0,6,0,-6
18646,1,0,22,0,-22
18647,1,1,1087,1275,188
18648,1,1,319,1761,1442
18649,1,1,260,1747,1487
18650,1,0,1,0,-1
18651,1,0,147,0,-147
18652,0,0,111,0,-111
18653,0,0,18,0,-18
18654,0,0,31,0,-31
18655,1,0,17,0,-17
18656,1,1,1724,2136,412
18657,0,0,31,0,-31
18658,1,1,401,1257,856
18659,1,0,18,0,-18
18660,1,0,34,0,-34
18661,0,0,59,0,-59
18662,0,0,31,0,-31
18663,1,0,36,0,-36
18664,1,0,100,0,-100
18665,0,0,123,0,-123
18666,1,0,93,0,-93
18667,1,1,564,4296,3732
18668,0,0,15,0,-15
18669,0,0,50,0,-50
18670,1,1,368,2123,1755
18671,1,1,117,1969,1852
18672,1,0,33,0,-33
18673,1,0,6,0,-6
18674,0,0,22,0,-22
18675,1,1,1473,1726,253
18676,1,1,1770,1310,-460
18677,0,0,15,0,-15
18678,1,1,920,2784,1864
18679,1,0,64,0,-64
18680,1,0,79,0,-79
18681,1,0,7,0,-7
18682,0,0,43,0,-43
18683,0,0,7,0,-7
18684,1,0,5,0,-5
18685,0,0,25,0,-25
18686,0,0,56,0,-56
18687,1,0,7,0,-7
18688,1,0,35,0,-35
18689,0,0,11,0,-11
18690,1,1,638,1320,682
18691,1,0,25,0,-25
18692,1,0,31,0,-31
18693,1,1,64,1322,1258
18694,0,0,38,0,-38
18695,0,0,40,0,-40
18696,0,0,92,0,-92
18697,1,0,87,0,-87
18698,1,1,761,1488,727
18699,0,0,17,0,-17
18700,0,0,4,0,-4
18701,0,0,31,0,-31
18702,1,0,36,0,-36
18703,1,0,38,0,-38
18704,1,0,13,0,-13
18705,1,0,4,0,-4
18706,1,1,161,1700,1539
18707,1,0,51,0,-51
18708,1,0,252,0,-252
18709,1,0,96,0,-96
18710,0,0,11,0,-11
18711,1,0,16,0,-16
18712,1,1,992,1351,359
18713,1,0,43,0,-43
18714,0,0,14,0,-14
18715,1,0,201,0,-201
18716,1,1,375,1394,1019
18717,1,1,226,1278,1052
18718,1,0,49,0,-49
18719,0,0,54,0,-54
18720,1,0,11,0,-11
18721,1,1,270,1338,1068
18722,1,1,1084,1691,607
18723,1,1,542,1285,743
18724,0,0,32,0,-32
18725,0,0,121,0,-121
18726,1,0,17,0,-17
18727,1,0,165,0,-165
18728,0,0,95,0,-95
18729,0,0,1,0,-1
18730,0,0,71,0,-71
18731,1,1,547,1513,966
18732,1,1,464,1713,1249
18733,1,0,197,0,-197
18734,1,1,72,1809,1737
18735,0,0,33,0,-33
18736,0,0,52,0,-52
18737,1,0,109,0,-109
18738,0,0,11,0,-11
18739,1,1,268,1494,1226
18740,1,1,331,1254,923
18741,0,0,7,0,-7
18742,1,1,390,1666,1276
18743,1,1,417,1539,1122
18744,0,0,25,0,-25
18745,1,1,121,1428,1307
18746,0,0,18,0,-18
18747,1,0,79,0,-79
18748,0,0,1,0,-1
18749,1,0,80,0,-80
18750,0,0,10,0,-10
18751,1,1,1035,1316,281
18752,0,0,22,0,-22
18753,1,1,109,1450,1341
18754,0,0,10,0,-10
18755,0,0,2,0,-2
18756,1,1,497,1233,736
18757,1,0,32,0,-32
18758,1,0,77,0,-77
18759,1,1,611,1239,628
18760,0,0,42,0,-42
18761,0,0,135,0,-135
18762,1,0,68,0,-68
18763,1,1,711,1467,756
18764,0,0,0,0,0
18765,0,0,2,0,-2
18766,1,0,13,0,-13
18767,0,0,33,0,-33
18768,0,0,60,0,-60
18769,1,1,159,1624,1465
18770,0,0,92,0,-92
18771,1,1,90,1565,1475
18772,1,0,37,0,-37
18773,1,0,88,0,-88
18774,1,0,27,0,-27
18775,1,0,2,0,-2
18776,0,0,113,0,-113
18777,1,0,65,0,-65
18778,1,0,105,0,-105
18779,1,1,1404,2013,609
18780,0,0,13,0,-13
18781,0,0,14,0,-14
18782,1,0,57,0,-57
18783,0,0,52,0,-52
18784,1,0,98,0,-98
18785,1,0,84,0,-84
18786,1,0,159,0,-159
18787,1,0,14,0,-14
18788,0,0,3,0,-3
18789,1,0,80,0,-80
18790,0,0,12,0,-12
18791,1,0,49,0,-49
18792,0,0,69,0,-69
18793,1,1,486,1239,753
18794,0,0,41,0,-41
18795,1,1,356,2143,1787
18796,0,0,22,0,-22
18797,1,1,581,2632,2051
18798,1,0,69,0,-69
18799,0,0,116,0,-116
18800,0,0,38,0,-38
18801,1,0,1,0,-1
18802,1,1,295,1211,916
18803,0,0,38,0,-38
18804,0,0,6,0,-6
18805,0,0,83,0,-83
18806,1,0,40,0,-40
18807,0,0,11,0,-11
18808,1,1,62,1230,1168
18809,1,0,165,0,-165
18810,1,0,1,0,-1
18811,1,0,13,0,-13
18812,1,0,78,0,-78
18813,0,0,100,0,-100
18814,1,1,570,1215,645
18815,1,0,27,0,-27
18816,0,0,104,0,-104
18817,1,0,12,0,-12
18818,1,1,1395,1377,-18
18819,1,1,105,1245,1140
18820,0,0,56,0,-56
18821,0,0,36,0,-36
18822,1,1,1069,1721,652
18823,1,1,117,1494,1377
18824,0,0,35,0,-35
18825,1,1,365,1309,944
18826,0,0,210,0,-210
18827,0,0,11,0,-11
18828,1,0,51,0,-51
18829,1,1,849,1230,381
18830,1,1,720,1444,724
18831,0,0,56,0,-56
18832,1,0,26,0,-26
18833,0,0,131,0,-131
18834,1,1,977,1426,449
18835,0,0,72,0,-72
18836,0,0,106,0,-106
18837,1,1,451,1248,797
18838,1,1,1329,1310,-19
18839,0,0,1,0,-1
18840,1,0,1,0,-1
18841,1,0,24,0,-24
18842,1,0,8,0,-8
18843,1,0,59,0,-59
18844,1,1,540,1302,762
18845,1,1,597,1209,612
18846,1,1,590,1549,959
18847,1,1,397,2670,2273
18848,0,0,17,0,-17
18849,1,0,26,0,-26
18850,0,0,144,0,-144
18851,0,0,4,0,-4
18852,1,0,67,0,-67
18853,0,0,44,0,-44
18854,0,0,35,0,-35
18855,1,1,629,1477,848
18856,0,0,64,0,-64
18857,0,0,29,0,-29
18858,1,1,103,1288,1185
18859,0,0,0,0,0
18860,1,0,48,0,-48
18861,1,0,30,0,-30
18862,1,0,33,0,-33
18863,1,0,4,0,-4
18864,1,0,14,0,-14
18865,1,1,323,1231,908
18866,0,0,24,0,-24
18867,1,1,177,1487,1310
18868,1,0,7,0,-7
18869,1,0,46,0,-46
18870,1,0,9,0,-9
18871,1,1,445,1922,1477
18872,0,0,23,0,-23
18873,1,1,437,1429,992
18874,0,0,75,0,-75
18875,1,0,7,0,-7
18876,1,1,576,1591,1015
18877,1,0,45,0,-45
18878,0,0,42,0,-42
18879,1,0,15,0,-15
18880,0,0,15,0,-15
18881,1,0,151,0,-151
18882,0,0,93,0,-93
18883,0,0,9,0,-9
18884,1,1,162,1569,1407
18885,1,0,1,0,-1
18886,1,0,87,0,-87
18887,0,0,10,0,-10
18888,1,0,37,0,-37
18889,1,1,492,1250,758
18890,0,0,43,0,-43
18891,1,1,414,1236,822
18892,1,0,79,0,-79
18893,0,0,82,0,-82
18894,1,1,1226,1549,323
18895,1,0,9,0,-9
18896,1,0,1,0,-1
18897,0,0,73,0,-73
18898,1,1,108,1368,1260
18899,0,0,58,0,-58
18900,1,0,52,0,-52
18901,1,1,67,1210,1143
18902,0,0,99,0,-99
18903,1,0,62,0,-62
18904,1,1,304,1464,1160
18905,1,1,372,1271,899
18906,0,0,113,0,-113
18907,1,0,3,0,-3
18908,1,0,70,0,-70
18909,0,0,30,0,-30
18910,0,0,6,0,-6
18911,1,1,93,1203,1110
18912,0,0,49,0,-49
18913,0,0,60,0,-60
18914,0,0,11,0,-11
18915,1,0,102,0,-102
18916,1,0,0,0,0
18917,1,1,549,1445,896
18918,1,0,40,0,-40
18919,1,1,275,1604,1329
18920,1,1,271,1202,931
18921,0,0,75,0,-75
18922,1,1,51,1488,1437
18923,0,0,57,0,-57
18924,1,0,98,0,-98
18925,1,1,1008,1211,203
18926,1,0,61,0,-61
18927,1,0,37,0,-37
18928,1,0,26,0,-26
18929,1,1,325,1240,915
18930,1,1,812,1485,673
18931,1,0,11,0,-11
18932,0,0,32,0,-32
18933,1,0,25,0,-25
18934,0,0,52,0,-52
18935,1,0,19,0,-19
18936,1,0,7,0,-7
18937,0,0,182,0,-182
18938,0,0,116,0,-116
18939,0,0,308,0,-308
18940,1,1,263,1471,1208
18941,1,1,393,1855,1462
18942,1,0,90,0,-90
18943,1,0,35,0,-35
18944,1,0,83,0,-83
18945,1,1,810,1397,587
18946,1,1,114,1272,1158
18947,1,1,485,1388,903
18948,1,0,216,0,-216
18949,1,1,382,1263,881
18950,1,1,158,1436,1278
18951,0,0,4,0,-4
18952,1,0,3,0,-3
18953,1,0,10,0,-10
18954,0,0,91,0,-91
18955,0,0,27,0,-27
18956,0,0,61,0,-61
18957,1,0,40,0,-40
18958,0,0,152,0,-152
18959,0,0,6,0,-6
18960,0,0,34,0,-34
18961,1,0,148,0,-148
18962,0,0,20,0,-20
18963,1,0,41,0,-41
18964,1,0,52,0,-52
18965,1,1,412,1276,864
18966,0,0,132,0,-132
18967,1,0,118,0,-118
18968,0,0,83,0,-83
18969,1,1,307,1409,1102
18970,0,0,18,0,-18
18971,1,0,72,0,-72
18972,1,0,112,0,-112
18973,1,1,423,1201,778
18974,1,1,95,1349,1254
18975,0,0,56,0,-56
18976,1,1,573,1210,637
18977,0,0,46,0,-46
18978,1,1,652,3635,2983
18979,0,0,9,0,-9
18980,1,0,42,0,-42
18981,1,1,175,1377,1202
18982,1,0,53,0,-53
18983,0,0,33,0,-33
18984,1,1,623,1448,825
18985,1,1,17,1640,1623
18986,1,1,90,2356,2266
18987,1,0,1,0,-1
18988,1,0,13,0,-13
18989,1,1,23,1285,1262
18990,1,1,1017,2398,1381
18991,1,1,1085,1360,275
18992,1,1,2757,1400,-1357
18993,1,1,126,1533,1407
18994,1,1,462,1741,1279
18995,1,1,36,1432,1396
18996,1,1,702,2239,1537
18997,0,0,40,0,-40
18998,1,1,5,2099,2094
18999,1,1,458,1251,793
19000,1,1,1139,1736,597
19001,0,0,2,0,-2
19002,1,1,1285,1216,-69
19003,0,0,29,0,-29
19004,0,0,46,0,-46
19005,1,0,199,0,-199
19006,0,0,282,0,-282
19007,1,0,46,0,-46
19008,0,0,73,0,-73
19009,1,1,273,1293,1020
19010,1,1,2135,1494,-641
19011,0,0,18,0,-18
19012,0,0,36,0,-36
19013,1,1,298,1537,1239
19014,1,1,329,2424,2095
19015,1,0,12,0,-12
19016,1,0,53,0,-53
19017,1,0,23,0,-23
19018,0,0,35,0,-35
19019,0,0,36,0,-36
19020,0,0,154,0,-154
19021,1,1,670,1294,624
19022,1,1,1532,1230,-302
19023,1,1,478,1733,1255
19024,0,0,9,0,-9
19025,1,1,589,1264,675
19026,0,0,15,0,-15
19027,1,0,0,0,0
19028,1,1,352,1734,1382
19029,1,0,12,0,-12
19030,1,0,29,0,-29
19031,1,1,254,1222,968
19032,1,0,40,0,-40
19033,0,0,21,0,-21
19034,1,1,232,1574,1342
19035,1,1,931,1287,356
19036,1,0,37,0,-37
19037,0,0,21,0,-21
19038,1,0,10,0,-10
19039,1,1,52,1796,1744
19040,1,1,54,1201,1147
19041,1,1,275,1919,1644
19042,0,0,43,0,-43
19043,1,1,1343,1382,39
19044,0,0,50,0,-50
19045,1,1,448,1571,1123
19046,1,0,95,0,-95
19047,1,1,1652,1256,-396
19048,0,0,5,0,-5
19049,0,0,13,0,-13
19050,1,0,23,0,-23
19051,0,0,37,0,-37
19052,0,0,41,0,-41
19053,1,1,145,1600,1455
19054,1,1,173,1201,1028
19055,0,0,9,0,-9
19056,0,0,20,0,-20
19057,1,0,90,0,-90
19058,0,0,236,0,-236
19059,1,0,6,0,-6
19060,0,0,77,0,-77
19061,0,0,19,0,-19
19062,0,0,3,0,-3
19063,1,0,17,0,-17
19064,1,0,0,0,0
19065,0,0,132,0,-132
19066,1,0,7,0,-7
19067,1,0,80,0,-80
19068,1,0,10,0,-10
19069,0,0,205,0,-205
19070,1,0,3,0,-3
19071,0,0,29,0,-29
19072,1,0,139,0,-139
19073,1,1,137,1561,1424
19074,1,1,378,1366,988
19075,1,0,55,0,-55
19076,1,1,703,1410,707
19077,1,0,53,0,-53
19078,1,0,39,0,-39
19079,1,0,18,0,-18
19080,1,1,92,2394,2302
19081,1,1,192,3181,2989
19082,1,0,89,0,-89
19083,0,0,51,0,-51
19084,0,0,26,0,-26
19085,1,1,640,2142,1502
19086,1,0,34,0,-34
19087,0,0,177,0,-177
19088,1,1,1956,2011,55
19089,0,0,104,0,-104
19090,1,1,657,2706,2049
19091,1,0,0,0,0
19092,0,0,136,0,-136
19093,1,1,51,2913,2862
19094,1,0,128,0,-128
19095,1,0,116,0,-116
19096,1,1,1238,1224,-14
19097,1,1,424,1297,873
19098,1,1,1220,1244,24
19099,0,0,21,0,-21
19100,1,0,30,0,-30
19101,1,0,46,0,-46
19102,1,0,43,0,-43
19103,0,0,16,0,-16
19104,0,0,10,0,-10
19105,1,1,957,1376,419
19106,0,0,210,0,-210
19107,0,0,70,0,-70
19108,1,0,26,0,-26
19109,0,0,32,0,-32
19110,1,1,153,1420,1267
19111,1,0,4,0,-4
19112,1,0,48,0,-48
19113,1,0,36,0,-36
19114,0,0,2,0,-2
19115,0,0,88,0,-88
19116,1,0,66,0,-66
19117,1,0,75,0,-75
19118,0,0,55,0,-55
19119,1,1,330,1429,1099
19120,0,0,45,0,-45
19121,1,1,1179,2636,1457
19122,0,0,96,0,-96
19123,1,0,49,0,-49
19124,1,0,45,0,-45
19125,0,0,21,0,-21
19126,1,1,1574,1331,-243
19127,0,0,7,0,-7
19128,0,0,31,0,-31
19129,0,0,181,0,-181
19130,1,0,62,0,-62
19131,1,1,133,1219,1086
19132,1,0,97,0,-97
19133,0,0,97,0,-97
19134,0,0,5,0,-5
19135,1,1,527,1259,732
19136,1,0,33,0,-33
19137,1,1,392,1297,905
19138,0,0,0,0,0
19139,0,0,35,0,-35
19140,1,0,90,0,-90
19141,1,1,288,1268,980
19142,0,0,6,0,-6
19143,0,0,19,0,-19
19144,1,0,132,0,-132
19145,1,1,58,2316,2258
19146,1,0,348,0,-348
19147,0,0,13,0,-13
19148,0,0,410,0,-410
19149,1,0,3,0,-3
19150,1,0,21,0,-21
19151,1,1,1865,2445,580
19152,0,0,64,0,-64
19153,1,0,61,0,-61
19154,0,0,144,0,-144
19155,1,0,15,0,-15
19156,1,0,11,0,-11
19157,1,0,24,0,-24
19158,1,0,42,0,-42
19159,0,0,17,0,-17
19160,1,0,21,0,-21
19161,0,0,57,0,-57
19162,0,0,45,0,-45
19163,1,1,438,1538,1100
19164,1,0,63,0,-63
19165,1,0,77,0,-77
19166,0,0,45,0,-45
19167,0,0,3,0,-3
19168,1,0,54,0,-54
19169,1,0,81,0,-81
19170,1,0,11,0,-11
19171,1,1,533,1310,777
19172,1,0,5,0,-5
19173,1,0,40,0,-40
19174,1,0,30,0,-30
19175,0,0,18,0,-18
19176,0,0,25,0,-25
19177,0,0,29,0,-29
19178,0,0,7,0,-7
19179,1,1,597,1301,704
19180,1,1,114,1573,1459
19181,1,1,278,1211,933
19182,1,1,852,1357,505
19183,0,0,16,0,-16
19184,1,0,10,0,-10
19185,0,0,44,0,-44
19186,1,0,71,0,-71
19187,1,0,27,0,-27
19188,1,0,36,0,-36
19189,0,0,31,0,-31
19190,1,1,314,1270,956
19191,0,0,87,0,-87
19192,1,1,1187,1264,77
19193,1,1,174,1253,1079
19194,1,0,1,0,-1
19195,1,0,16,0,-16
19196,0,0,51,0,-51
19197,1,1,537,1389,852
19198,1,0,5,0,-5
19199,0,0,31,0,-31
19200,1,1,754,1481,727
19201,1,1,318,1536,1218
19202,1,0,44,0,-44
19203,1,1,54,2167,2113
19204,1,1,131,1282,1151
19205,0,0,30,0,-30
19206,1,0,26,0,-26
19207,1,1,38,1200,1162
19208,0,0,95,0,-95
19209,1,1,531,1616,1085
19210,0,0,24,0,-24
19211,0,0,175,0,-175
19212,1,0,0,0,0
19213,1,0,30,0,-30
19214,1,0,19,0,-19
19215,0,0,82,0,-82
19216,1,1,866,1653,787
19217,1,0,134,0,-134
19218,1,1,59,3313,3254
19219,1,0,4,0,-4
19220,0,0,3,0,-3
19221,0,0,1,0,-1
19222,1,1,333,1225,892
19223,0,0,136,0,-136
19224,1,1,31,1599,1568
19225,0,0,27,0,-27
19226,0,0,1,0,-1
19227,1,0,87,0,-87
19228,0,0,66,0,-66
19229,1,1,1794,1604,-190
19230,1,0,10,0,-10
19231,1,0,2,0,-2
19232,1,0,85,0,-85
19233,1,0,46,0,-46
19234,1,1,240,1298,1058
19235,1,0,8,0,-8
19236,1,1,162,1611,1449
19237,1,0,5,0,-5
19238,1,1,3416,1690,-1726
19239,0,0,44,0,-44
19240,0,0,27,0,-27
19241,1,1,539,1202,663
19242,0,0,71,0,-71
19243,0,0,40,0,-40
19244,0,0,38,0,-38
19245,0,0,27,0,-27
19246,1,0,21,0,-21
19247,1,0,18,0,-18
19248,1,1,120,1486,1366
19249,1,1,1219,1309,90
19250,0,0,30,0,-30
19251,0,0,191,0,-191
19252,1,1,90,1518,1428
19253,1,1,1092,1200,108
19254,0,0,12,0,-12
19255,0,0,51,0,-51
19256,1,1,191,1243,1052
19257,1,1,452,1203,751
19258,1,0,7,0,-7
19259,0,0,100,0,-100
19260,0,0,15,0,-15
19261,1,0,20,0,-20
19262,0,0,138,0,-138
19263,0,0,22,0,-22
19264,1,1,59,1959,1900
19265,1,1,90,1455,1365
19266,1,1,293,1423,1130
19267,1,0,61,0,-61
19268,0,0,166,0,-166
19269,1,0,7,0,-7
19270,1,1,1324,1238,-86
19271,0,0,27,0,-27
19272,1,0,2,0,-2
19273,0,0,19,0,-19
19274,0,0,42,0,-42
19275,1,1,1150,1497,347
19276,0,0,15,0,-15
19277,0,0,0,0,0
19278,0,0,93,0,-93
19279,0,0,139,0,-139
19280,0,0,57,0,-57
19281,1,1,716,2412,1696
19282,1,0,45,0,-45
19283,0,0,14,0,-14
19284,1,0,36,0,-36
19285,0,0,17,0,-17
19286,1,0,7,0,-7
19287,1,0,13,0,-13
19288,1,0,4,0,-4
19289,1,0,5,0,-5
19290,1,1,247,1345,1098
19291,1,1,900,1442,542
19292,1,1,156,1219,1063
19293,0,0,4,0,-4
19294,0,0,134,0,-134
19295,1,0,29,0,-29
19296,0,0,18,0,-18
19297,1,1,557,1344,787
19298,0,0,2,0,-2
19299,0,0,6,0,-6
19300,1,1,769,1442,673
19301,1,0,7,0,-7
19302,1,0,31,0,-31
19303,1,1,355,1465,1110
19304,0,0,38,0,-38
19305,0,0,55,0,-55
19306,0,0,275,0,-275
19307,1,1,955,1396,441
19308,1,1,1095,5089,3994
19309,1,0,20,0,-20
19310,1,0,12,0,-12
19311,1,1,682,1285,603
19312,1,1,442,1355,913
19313,1,0,3,0,-3
19314,1,0,1,0,-1
19315,1,0,38,0,-38
19316,1,1,381,1518,1137
19317,1,1,1735,1530,-205
19318,0,0,56,0,-56
19319,1,1,837,1476,639
19320,1,1,766,1364,598
19321,1,1,27,1214,1187
19322,1,0,2,0,-2
19323,1,1,720,2422,1702
19324,0,0,82,0,-82
19325,1,0,90,0,-90
19326,1,1,1620,1399,-221
19327,1,1,95,1288,1193
19328,0,0,14,0,-14
19329,1,1,134,1678,1544
19330,0,0,7,0,-7
19331,1,0,2,0,-2
19332,1,1,1174,1656,482
19333,0,0,65,0,-65
19334,1,0,9,0,-9
19335,1,1,1914,1202,-712
19336,1,1,108,1239,1131
19337,0,0,126,0,-126
19338,0,0,33,0,-33
19339,0,0,46,0,-46
19340,0,0,10,0,-10
19341,1,0,104,0,-104
19342,1,1,210,1924,1714
19343,0,0,7,0,-7
19344,1,1,170,1258,1088
19345,1,1,606,1324,718
19346,0,0,19,0,-19
19347,1,1,366,1218,852
19348,0,0,13,0,-13
19349,1,1,1702,1230,-472
19350,1,0,56,0,-56
19351,1,0,138,0,-138
19352,1,1,96,1221,1125
19353,1,0,12,0,-12
19354,1,0,36,0,-36
19355,1,1,1217,1917,700
19356,1,0,21,0,-21
19357,0,0,77,0,-77
19358,0,0,30,0,-30
19359,1,0,3,0,-3
19360,0,0,15,0,-15
19361,0,0,80,0,-80
19362,1,1,350,1298,948
19363,1,1,546,1645,1099
19364,0,0,191,0,-191
19365,0,0,33,0,-33
19366,1,0,60,0,-60
19367,0,0,53,0,-53
19368,1,1,354,1970,1616
19369,1,0,10,0,-10
19370,1,0,231,0,-231
19371,1,1,207,1434,1227
19372,1,1,1598,1272,-326
19373,0,0,70,0,-70
19374,0,0,66,0,-66
19375,1,1,290,1746,1456
19376,0,0,26,0,-26
19377,1,1,249,1456,1207
19378,0,0,9,0,-9
19379,1,1,81,1678,1597
19380,0,0,49,0,-49
19381,1,0,14,0,-14
19382,0,0,69,0,-69
19383,1,0,88,0,-88
19384,0,0,12,0,-12
19385,0,0,123,0,-123
19386,1,1,288,1266,978
19387,1,0,180,0,-180
19388,1,1,192,1421,1229
19389,0,0,13,0,-13
19390,0,0,120,0,-120
19391,0,0,69,0,-69
19392,0,0,227,0,-227
19393,0,0,78,0,-78
19394,1,1,239,1553,1314
19395,0,0,118,0,-118
19396,0,0,64,0,-64
19397,0,0,0,0,0
19398,0,0,5,0,-5
19399,0,0,23,0,-23
19400,0,0,4,0,-4
19401,1,1,480,3029,2549
19402,1,0,9,0,-9
19403,1,0,101,0,-101
19404,1,0,24,0,-24
19405,0,0,187,0,-187
19406,0,0,54,0,-54
19407,1,1,599,1463,864
19408,1,0,92,0,-92
19409,1,0,69,0,-69
19410,0,0,37,0,-37
19411,0,0,40,0,-40
19412,1,1,37,1395,1358
19413,0,0,22,0,-22
19414,0,0,25,0,-25
19415,0,0,7,0,-7
19416,1,1,262,1877,1615
19417,0,0,45,0,-45
19418,1,1,317,1298,981
19419,1,0,8,0,-8
19420,1,1,275,1669,1394
19421,1,0,44,0,-44
19422,0,0,58,0,-58
19423,1,1,686,1211,525
19424,1,0,27,0,-27
19425,1,0,55,0,-55
19426,1,1,952,1232,280
19427,1,0,96,0,-96
19428,0,0,11,0,-11
19429,1,0,31,0,-31
19430,0,0,69,0,-69
19431,1,0,125,0,-125
19432,1,1,81,1806,1725
19433,1,1,303,1255,952
19434,1,0,90,0,-90
19435,0,0,142,0,-142
19436,1,0,114,0,-114
19437,0,0,47,0,-47
19438,1,1,1513,1397,-116
19439,1,1,954,1473,519
19440,1,0,39,0,-39
19441,1,0,13,0,-13
19442,0,0,3,0,-3
19443,1,0,16,0,-16
19444,1,0,7,0,-7
19445,0,0,5,0,-5
19446,1,1,221,1213,992
19447,1,0,7,0,-7
19448,0,0,18,0,-18
19449,1,1,43,1629,1586
19450,1,0,34,0,-34
19451,1,0,35,0,-35
19452,1,1,431,1840,1409
19453,1,0,7,0,-7
19454,0,0,17,0,-17
19455,1,1,855,1701,846
19456,1,0,29,0,-29
19457,1,1,419,1286,867
19458,1,0,53,0,-53
19459,0,0,137,0,-137
19460,0,0,13,0,-13
19461,0,0,2,0,-2
19462,1,0,9,0,-9
19463,1,1,864,1491,627
19464,1,0,22,0,-22
19465,0,0,2,0,-2
19466,0,0,13,0,-13
19467,0,0,7,0,-7
19468,1,0,123,0,-123
19469,1,0,15,0,-15
19470,0,0,2,0,-2
19471,1,1,410,1266,856
19472,1,1,267,1369,1102
19473,1,0,62,0,-62
19474,0,0,25,0,-25
19475,0,0,11,0,-11
19476,1,0,255,0,-255
19477,0,0,1,0,-1
19478,0,0,18,0,-18
19479,1,1,193,1224,1031
19480,1,1,406,1959,1553
19481,0,0,32,0,-32
19482,0,0,65,0,-65
19483,0,0,69,0,-69
19484,1,1,331,2037,1706
19485,0,0,177,0,-177
19486,1,1,292,1267,975
19487,0,0,8,0,-8
19488,1,1,480,1273,793
19489,1,0,4,0,-4
19490,0,0,2,0,-2
19491,1,0,13,0,-13
19492,0,0,25,0,-25
19493,0,0,76,0,-76
19494,0,0,71,0,-71
19495,0,0,3,0,-3
19496,0,0,66,0,-66
19497,1,1,250,1483,1233
19498,0,0,17,0,-17
19499,1,0,0,0,0
19500,1,0,103,0,-103
19501,1,1,129,2091,1962
19502,1,1,2715,1458,-1257
19503,0,0,178,0,-178
19504,1,1,588,3485,2897
19505,0,0,31,0,-31
19506,0,0,128,0,-128
19507,0,0,7,0,-7
19508,1,0,47,0,-47
19509,0,0,48,0,-48
19510,1,0,48,0,-48
19511,1,1,861,2047,1186
19512,0,0,40,0,-40
19513,1,0,5,0,-5
19514,0,0,0,0,0
19515,0,0,0,0,0
19516,1,1,315,1583,1268
19517,1,1,351,1580,1229
19518,1,1,26,1339,1313
19519,1,1,399,1222,823
19520,1,1,153,1399,1246
19521,0,0,20,0,-20
19522,1,0,77,0,-77
19523,0,0,39,0,-39
19524,0,0,139,0,-139
19525,1,0,57,0,-57
19526,0,0,109,0,-109
19527,0,0,89,0,-89
19528,1,1,391,1262,871
19529,1,0,43,0,-43
19530,1,1,510,1406,896
19531,1,1,1170,1278,108
19532,0,0,29,0,-29
19533,1,1,92,1977,1885
19534,1,1,48,1392,1344
19535,0,0,52,0,-52
19536,0,0,95,0,-95
19537,1,0,141,0,-141
19538,1,1,823,1553,730
19539,1,0,22,0,-22
19540,0,0,5,0,-5
19541,1,0,17,0,-17
19542,0,0,8,0,-8
19543,0,0,31,0,-31
19544,1,0,45,0,-45
19545,1,1,730,1253,523
19546,1,0,176,0,-176
19547,1,1,194,1287,1093
19548,0,0,27,0,-27
19549,1,1,377,1619,1242
19550,1,1,300,1300,1000
19551,0,0,15,0,-15
19552,1,1,253,1964,1711
19553,0,0,50,0,-50
19554,1,0,30,0,-30
19555,1,1,795,1478,683
19556,1,1,865,1251,386
19557,1,0,26,0,-26
19558,0,0,45,0,-45
19559,1,0,35,0,-35
19560,1,1,143,1427,1284
19561,1,0,9,0,-9
19562,0,0,72,0,-72
19563,1,1,229,1288,1059
19564,1,1,1047,1213,166
19565,0,0,58,0,-58
19566,1,1,165,1220,1055
19567,1,1,289,1550,1261
19568,0,0,90,0,-90
19569,1,0,22,0,-22
19570,1,0,87,0,-87
19571,1,0,119,0,-119
19572,1,1,24,2224,2200
19573,1,0,85,0,-85
19574,1,1,284,1276,992
19575,1,0,190,0,-190
19576,1,1,447,1410,963
19577,0,0,13,0,-13
19578,1,0,13,0,-13
19579,0,0,11,0,-11
19580,1,1,398,1618,1220
19581,1,1,117,1235,1118
19582,1,0,14,0,-14
19583,1,1,708,1433,725
19584,1,1,106,1309,1203
19585,1,0,37,0,-37
19586,1,1,223,1659,1436
19587,1,1,1013,3452,2439
19588,1,1,168,1286,1118
19589,0,0,44,0,-44
19590,1,0,4,0,-4
19591,0,0,99,0,-99
19592,1,0,134,0,-134
19593,1,1,229,2461,2232
19594,0,0,48,0,-48
19595,1,0,11,0,-11
19596,0,0,103,0,-103
19597,1,0,9,0,-9
19598,1,1,374,1420,1046
19599,0,0,19,0,-19
19600,1,0,198,0,-198
19601,0,0,65,0,-65
19602,0,0,64,0,-64
19603,0,0,92,0,-92
19604,1,1,527,1801,1274
19605,0,0,32,0,-32
19606,1,0,29,0,-29
19607,1,0,18,0,-18
19608,0,0,108,0,-108
19609,1,1,701,1748,1047
19610,1,1,338,2158,1820
19611,1,0,4,0,-4
19612,0,0,6,0,-6
19613,1,0,22,0,-22
19614,1,0,46,0,-46
19615,0,0,35,0,-35
19616,1,1,65,1460,1395
19617,1,0,11,0,-11
19618,0,0,114,0,-114
19619,0,0,53,0,-53
19620,1,1,2339,1432,-907
19621,1,1,767,1294,527
19622,1,0,33,0,-33
19623,0,0,5,0,-5
19624,0,0,145,0,-145
19625,1,1,388,1429,1041
19626,1,1,942,1617,675
19627,0,0,42,0,-42
19628,0,0,61,0,-61
19629,0,0,7,0,-7
19630,0,0,7,0,-7
19631,1,0,45,0,-45
19632,0,0,33,0,-33
19633,0,0,118,0,-118
19634,1,1,388,1627,1239
19635,1,1,959,1389,430
19636,1,1,452,1574,1122
19637,0,0,26,0,-26
19638,1,1,911,1753,842
19639,1,1,508,1528,1020
19640,1,0,21,0,-21
19641,1,1,1387,1353,-34
19642,1,1,1869,1474,-395
19643,1,1,235,1200,965
19644,0,0,79,0,-79
19645,1,0,52,0,-52
19646,0,0,113,0,-113
19647,1,0,158,0,-158
19648,0,0,172,0,-172
19649,0,0,270,0,-270
19650,1,1,368,1457,1089
19651,0,0,3,0,-3
19652,1,1,1064,1228,164
19653,1,0,61,0,-61
19654,0,0,76,0,-76
19655,0,0,3,0,-3
19656,0,0,120,0,-120
19657,0,0,33,0,-33
19658,1,1,228,1516,1288
19659,0,0,22,0,-22
19660,1,0,23,0,-23
19661,1,0,70,0,-70
19662,1,0,31,0,-31
19663,1,0,64,0,-64
19664,1,1,47,1219,1172
19665,1,0,1,0,-1
19666,1,1,483,1480,997
19667,1,1,304,1356,1052
19668,1,0,4,0,-4
19669,0,0,15,0,-15
19670,0,0,0,0,0
19671,1,1,1031,1209,178
19672,1,0,42,0,-42
19673,1,0,36,0,-36
19674,0,0,4,0,-4
19675,1,1,276,1394,1118
19676,1,1,20,1263,1243
19677,1,1,176,1260,1084
19678,1,0,40,0,-40
19679,1,0,25,0,-25
19680,1,1,2614,1268,-1346
19681,0,0,73,0,-73
19682,0,0,41,0,-41
19683,1,0,4,0,-4
19684,0,0,51,0,-51
19685,1,1,204,1757,1553
19686,1,1,620,1303,683
19687,1,0,67,0,-67
19688,1,1,237,1483,1246
19689,1,1,354,1777,1423
19690,1,1,1317,2246,929
19691,1,0,84,0,-84
19692,0,0,67,0,-67
19693,0,0,31,0,-31
19694,1,0,76,0,-76
19695,0,0,1,0,-1
19696,0,0,70,0,-70
19697,0,0,8,0,-8
19698,1,0,23,0,-23
19699,0,0,58,0,-58
19700,1,1,313,1235,922
19701,0,0,70,0,-70
19702,1,0,8,0,-8
19703,1,0,12,0,-12
19704,0,0,91,0,-91
19705,0,0,63,0,-63
19706,0,0,150,0,-150
19707,1,0,0,0,0
19708,0,0,0,0,0
19709,0,0,82,0,-82
19710,1,1,1237,1660,423
19711,0,0,26,0,-26
19712,1,1,154,1245,1091
19713,1,0,113,0,-113
19714,1,0,1,0,-1
19715,0,0,43,0,-43
19716,0,0,0,0,0
19717,0,0,27,0,-27
19718,0,0,9,0,-9
19719,1,0,48,0,-48
19720,1,0,13,0,-13
19721,0,0,19,0,-19
19722,0,0,70,0,-70
19723,0,0,23,0,-23
19724,1,0,10,0,-10
19725,1,1,389,3531,3142
19726,1,1,183,1204,1021
19727,0,0,44,0,-44
19728,1,1,2644,1399,-1245
19729,0,0,29,0,-29
19730,0,0,15,0,-15
19731,0,0,26,0,-26
19732,1,0,3,0,-3
19733,1,1,393,1440,1047
19734,1,0,7,0,-7
19735,1,1,431,1590,1159
19736,0,0,40,0,-40
19737,0,0,15,0,-15
19738,1,1,227,1853,1626
19739,1,1,233,1254,1021
19740,1,1,196,1256,1060
19741,0,0,34,0,-34
19742,0,0,13,0,-13
19743,1,1,746,1440,694
19744,1,1,425,1558,1133
19745,1,0,107,0,-107
19746,1,0,24,0,-24
19747,1,1,545,1259,714
19748,0,0,20,0,-20
19749,1,0,34,0,-34
19750,1,1,937,1325,388
19751,1,1,267,1564,1297
19752,0,0,17,0,-17
19753,0,0,23,0,-23
19754,0,0,21,0,-21
19755,1,1,318,1325,1007
19756,0,0,140,0,-140
19757,0,0,15,0,-15
19758,1,1,211,1822,1611
19759,1,1,1747,1206,-541
19760,1,1,248,1492,1244
19761,0,0,27,0,-27
19762,0,0,10,0,-10
19763,1,1,116,1750,1634
19764,0,0,17,0,-17
19765,0,0,7,0,-7
19766,1,0,31,0,-31
19767,0,0,8,0,-8
19768,0,0,0,0,0
19769,1,1,962,1318,356
19770,1,1,603,1292,689
19771,1,0,228,0,-228
19772,1,1,110,1320,1210
19773,1,1,720,1665,945
19774,1,1,706,1269,563
19775,0,0,44,0,-44
19776,1,0,313,0,-313
19777,0,0,2,0,-2
19778,1,0,37,0,-37
19779,1,1,312,1358,1046
19780,1,0,46,0,-46
19781,0,0,0,0,0
19782,0,0,114,0,-114
19783,0,0,12,0,-12
19784,0,0,1,0,-1
19785,0,0,54,0,-54
19786,1,0,27,0,-27
19787,1,0,107,0,-107
19788,0,0,102,0,-102
19789,1,1,567,2094,1527
19790,0,0,6,0,-6
19791,0,0,62,0,-62
19792,1,0,48,0,-48
19793,0,0,17,0,-17
19794,1,0,2,0,-2
19795,0,0,19,0,-19
19796,1,1,1364,1662,298
19797,1,0,62,0,-62
19798,0,0,7,0,-7
19799,1,1,310,1206,896
19800,1,0,100,0,-100
19801,0,0,16,0,-16
19802,1,0,25,0,-25
19803,1,0,60,0,-60
19804,1,1,854,1784,930
19805,1,1,428,2095,1667
19806,1,1,1859,2053,194
19807,0,0,28,0,-28
19808,0,0,69,0,-69
19809,1,0,5,0,-5
19810,1,0,29,0,-29
19811,1,1,98,1254,1156
19812,0,0,91,0,-91
19813,1,1,342,1904,1562
19814,1,0,12,0,-12
19815,0,0,15,0,-15
19816,1,1,1317,1552,235
19817,0,0,16,0,-16
19818,0,0,229,0,-229
19819,0,0,1,0,-1
19820,1,1,921,2509,1588
19821,1,0,31,0,-31
19822,0,0,2,0,-2
19823,0,0,11,0,-11
19824,1,1,342,1337,995
19825,1,0,114,0,-114
19826,1,1,563,1803,1240
19827,0,0,24,0,-24
19828,1,1,2489,1793,-696
19829,0,0,46,0,-46
19830,1,1,260,1214,954
19831,0,0,12,0,-12
19832,1,0,57,0,-57
19833,0,0,13,0,-13
19834,0,0,92,0,-92
19835,1,0,29,0,-29
19836,1,0,33,0,-33
19837,1,1,175,1390,1215
19838,1,0,2,0,-2
19839,1,1,503,1448,945
19840,1,0,64,0,-64
19841,1,1,244,1317,1073
19842,1,1,1049,2667,1618
19843,1,0,9,0,-9
19844,1,1,546,1408,862
19845,1,0,1,0,-1
19846,1,0,4,0,-4
19847,0,0,44,0,-44
19848,0,0,37,0,-37
19849,0,0,114,0,-114
19850,0,0,64,0,-64
19851,1,1,92,1359,1267
19852,1,0,27,0,-27
19853,0,0,11,0,-11
19854,1,0,21,0,-21
19855,1,1,356,1743,1387
19856,1,0,59,0,-59
19857,1,1,146,1298,1152
19858,0,0,0,0,0
19859,1,0,6,0,-6
19860,1,0,65,0,-65
19861,0,0,17,0,-17
19862,0,0,10,0,-10
19863,1,1,1691,1671,-20
19864,1,1,52,1406,1354
19865,0,0,21,0,-21
19866,0,0,5,0,-5
19867,0,0,12,0,-12
19868,1,1,214,2597,2383
19869,1,0,5,0,-5
19870,1,0,16,0,-16
19871,0,0,37,0,-37
19872,1,1,791,2704,1913
19873,1,1,329,1305,976
19874,0,0,24,0,-24
19875,1,0,4,0,-4
19876,0,0,2,0,-2
19877,1,0,14,0,-14
19878,0,0,39,0,-39
19879,0,0,33,0,-33
19880,1,0,26,0,-26
19881,1,0,21,0,-21
19882,0,0,84,0,-84
19883,1,1,534,1374,840
19884,1,0,7,0,-7
19885,1,1,337,1341,1004
19886,1,1,745,1446,701
19887,1,0,14,0,-14
19888,1,1,106,1352,1246
19889,1,0,33,0,-33
19890,1,1,80,1581,1501
19891,1,0,100,0,-100
19892,0,0,54,0,-54
19893,1,0,170,0,-170
19894,1,0,19,0,-19
19895,1,0,31,0,-31
19896,0,0,6,0,-6
19897,1,0,69,0,-69
19898,1,0,7,0,-7
19899,1,1,669,1294,625
19900,0,0,69,0,-69
19901,1,1,661,1591,930
19902,1,1,204,1882,1678
19903,1,1,707,1429,722
19904,1,1,367,1811,1444
19905,0,0,31,0,-31
19906,0,0,14,0,-14
19907,1,1,373,1315,942
19908,1,1,346,1234,888
19909,1,1,1327,1634,307
19910,1,1,407,1203,796
19911,0,0,29,0,-29
19912,1,0,54,0,-54
19913,0,0,2,0,-2
19914,1,1,688,1580,892
19915,1,1,335,1364,1029
19916,1,1,128,1740,1612
19917,0,0,64,0,-64
19918,0,0,46,0,-46
19919,1,1,18,1245,1227
19920,1,0,25,0,-25
19921,1,0,12,0,-12
19922,1,0,140,0,-140
19923,1,0,16,0,-16
19924,0,0,19,0,-19
19925,1,1,1325,1238,-87
19926,1,0,6,0,-6
19927,0,0,80,0,-80
19928,1,1,339,1632,1293
19929,0,0,225,0,-225
19930,1,1,407,1551,1144
19931,1,0,25,0,-25
19932,1,0,25,0,-25
19933,1,1,1249,2167,918
19934,0,0,38,0,-38
19935,0,0,110,0,-110
19936,1,1,108,1437,1329
19937,0,0,4,0,-4
19938,1,0,7,0,-7
19939,1,1,156,1992,1836
19940,1,1,956,1212,256
19941,1,1,456,1507,1051
19942,1,0,79,0,-79
19943,1,1,579,1270,691
19944,0,0,40,0,-40
19945,0,0,16,0,-16
19946,0,0,60,0,-60
19947,1,0,67,0,-67
19948,1,0,27,0,-27
19949,1,1,27,1539,1512
19950,1,0,133,0,-133
19951,1,0,215,0,-215
19952,0,0,66,0,-66
19953,0,0,42,0,-42
19954,1,0,112,0,-112
19955,1,0,2,0,-2
19956,1,0,11,0,-11
19957,0,0,5,0,-5
19958,1,1,169,1353,1184
19959,0,0,13,0,-13
19960,0,0,16,0,-16
19961,0,0,27,0,-27
19962,1,0,17,0,-17
19963,1,1,1205,2782,1577
19964,1,0,25,0,-25
19965,1,1,185,1989,1804
19966,1,1,255,1283,1028
19967,0,0,151,0,-151
19968,1,1,395,1227,832
19969,1,0,13,0,-13
19970,1,1,1022,1789,767
19971,1,1,435,1540,1105
19972,1,1,597,1583,986
19973,1,0,176,0,-176
19974,0,0,19,0,-19
19975,1,0,26,0,-26
19976,1,0,6,0,-6
19977,0,0,28,0,-28
19978,1,1,145,1235,1090
19979,1,1,1194,1217,23
19980,1,0,5,0,-5
19981,1,1,335,1499,1164
19982,1,1,180,1786,1606
19983,1,1,188,1200,1012
19984,0,0,15,0,-15
19985,0,0,5,0,-5
19986,0,0,91,0,-91
19987,1,0,139,0,-139
19988,0,0,13,0,-13
19989,1,0,175,0,-175
19990,0,0,34,0,-34
19991,1,0,6,0,-6
19992,1,1,104,1615,1511
19993,1,0,87,0,-87
19994,1,1,66,1456,1390
19995,0,0,54,0,-54
19996,1,0,184,0,-184
19997,1,0,167,0,-167
19998,1,0,15,0,-15
19999,1,0,10,0,-10
20000,0,0,7,0,-7
20001,0,0,35,0,-35
20002,1,1,119,1514,1395
20003,0,0,79,0,-79
20004,1,0,38,0,-38
20005,1,0,6,0,-6
20006,1,1,55,2021,1966
20007,1,1,607,1316,709
20008,1,0,48,0,-48
20009,0,0,50,0,-50
20010,1,1,641,1261,620
20011,0,0,24,0,-24
20012,1,1,263,1220,957
20013,1,0,67,0,-67
20014,1,1,582,1638,1056
20015,1,0,94,0,-94
20016,1,0,38,0,-38
20017,0,0,5,0,-5
20018,1,1,176,1370,1194
20019,1,0,109,0,-109
20020,1,0,63,0,-63
20021,1,1,103,1348,1245
20022,1,0,4,0,-4
20023,1,0,126,0,-126
20024,1,1,413,1377,964
20025,1,0,37,0,-37
20026,1,0,44,0,-44
20027,1,0,92,0,-92
20028,1,1,349,1230,881
20029,1,0,0,0,0
20030,1,0,102,0,-102
20031,0,0,66,0,-66
20032,1,1,1457,2343,886
20033,1,1,602,1568,966
20034,0,0,19,0,-19
20035,1,0,47,0,-47
20036,1,0,28,0,-28
20037,1,1,2371,1269,-1102
20038,0,0,40,0,-40
20039,1,1,271,1389,1118
20040,1,0,48,0,-48
20041,0,0,47,0,-47
20042,1,1,228,2842,2614
20043,1,1,328,1229,901
20044,1,0,49,0,-49
20045,1,0,18,0,-18
20046,1,1,1993,1295,-698
20047,0,0,95,0,-95
20048,1,0,200,0,-200
20049,0,0,45,0,-45
20050,1,0,24,0,-24
20051,1,0,79,0,-79
20052,1,0,119,0,-119
20053,0,0,5,0,-5
20054,1,1,2085,1467,-618
20055,1,0,61,0,-61
20056,1,0,90,0,-90
20057,0,0,32,0,-32
20058,1,1,506,1243,737
20059,0,0,70,0,-70
20060,1,1,356,1218,862
20061,0,0,32,0,-32
20062,1,0,26,0,-26
20063,1,1,178,1211,1033
20064,0,0,32,0,-32
20065,1,1,251,1464,1213
20066,1,1,569,1285,716
20067,1,0,12,0,-12
20068,0,0,29,0,-29
20069,0,0,60,0,-60
20070,1,0,11,0,-11
20071,0,0,25,0,-25
20072,0,0,21,0,-21
20073,0,0,34,0,-34
20074,1,0,30,0,-30
20075,0,0,101,0,-101
20076,0,0,12,0,-12
20077,1,1,83,1232,1149
20078,0,0,26,0,-26
20079,1,1,322,1798,1476
20080,1,0,45,0,-45
20081,1,0,12,0,-12
20082,1,0,110,0,-110
20083,0,0,25,0,-25
20084,0,0,10,0,-10
20085,0,0,23,0,-23
20086,0,0,54,0,-54
20087,0,0,33,0,-33
20088,0,0,48,0,-48
20089,1,0,73,0,-73
20090,0,0,23,0,-23
20091,0,0,11,0,-11
20092,1,0,5,0,-5
20093,1,0,97,0,-97
20094,1,1,368,1320,952
20095,0,0,153,0,-153
20096,1,0,80,0,-80
20097,0,0,17,0,-17
20098,0,0,61,0,-61
20099,1,0,91,0,-91
20100,1,1,303,1375,1072
20101,0,0,94,0,-94
20102,1,1,387,1396,1009
20103,0,0,91,0,-91
20104,0,0,19,0,-19
20105,1,0,72,0,-72
20106,1,0,81,0,-81
20107,0,0,255,0,-255
20108,0,0,154,0,-154
20109,1,0,28,0,-28
20110,1,0,23,0,-23
20111,1,0,76,0,-76
20112,1,0,3,0,-3
20113,0,0,251,0,-251
20114,0,0,73,0,-73
20115,1,1,127,2190,2063
20116,1,1,840,1362,522
20117,1,0,182,0,-182
20118,0,0,120,0,-120
20119,1,1,340,1209,869
20120,0,0,8,0,-8
20121,1,1,535,1308,773
20122,1,1,1111,1552,441
20123,1,1,690,1538,848
20124,1,1,351,2158,1807
20125,1,1,244,1322,1078
20126,1,1,321,1297,976
20127,1,0,1,0,-1
20128,0,0,31,0,-31
20129,1,1,102,2952,2850
20130,1,0,42,0,-42
20131,1,0,0,0,0
20132,1,1,127,2613,2486
20133,1,0,7,0,-7
20134,0,0,86,0,-86
20135,0,0,80,0,-80
20136,0,0,55,0,-55
20137,1,1,69,1704,1635
20138,0,0,11,0,-11
20139,1,0,26,0,-26
20140,0,0,68,0,-68
20141,1,1,135,1491,1356
20142,1,1,3313,1480,-1833
20143,1,0,67,0,-67
20144,0,0,137,0,-137
20145,1,0,9,0,-9
20146,1,1,104,1422,1318
20147,0,0,3,0,-3
20148,0,0,14,0,-14
20149,1,0,22,0,-22
20150,0,0,19,0,-19
20151,1,1,74,1376,1302
20152,0,0,25,0,-25
20153,0,0,6,0,-6
20154,0,0,9,0,-9
20155,1,1,522,1255,733
20156,0,0,51,0,-51
20157,1,1,568,1221,653
20158,1,0,62,0,-62
20159,1,1,86,1221,1135
20160,1,0,49,0,-49
20161,0,0,71,0,-71
20162,1,1,50,1283,1233
20163,1,0,86,0,-86
20164,1,1,359,1395,1036
20165,1,1,189,1502,1313
20166,1,1,404,1253,849
20167,0,0,84,0,-84
20168,1,1,401,1875,1474
20169,0,0,103,0,-103
20170,1,0,34,0,-34
20171,0,0,0,0,0
20172,1,0,24,0,-24
20173,0,0,18,0,-18
20174,1,1,550,2995,2445
20175,1,0,39,0,-39
20176,1,0,74,0,-74
20177,1,0,0,0,0
20178,1,0,27,0,-27
20179,0,0,32,0,-32
20180,1,0,7,0,-7
20181,1,1,2627,1574,-1053
20182,1,0,107,0,-107
20183,1,1,97,1426,1329
20184,1,0,123,0,-123
20185,0,0,42,0,-42
20186,1,1,203,1458,1255
20187,1,1,237,1986,1749
20188,1,1,1760,1218,-542
20189,1,0,85,0,-85
20190,1,1,429,1285,856
20191,1,0,12,0,-12
20192,0,0,221,0,-221
20193,1,1,212,1702,1490
20194,0,0,25,0,-25
20195,0,0,79,0,-79
20196,0,0,8,0,-8
20197,0,0,126,0,-126
20198,0,0,207,0,-207
20199,0,0,58,0,-58
20200,1,1,221,1252,1031
20201,0,0,131,0,-131
20202,1,0,29,0,-29
20203,1,1,494,1618,1124
20204,0,0,21,0,-21
20205,1,0,7,0,-7
20206,1,0,22,0,-22
20207,0,0,42,0,-42
20208,0,0,165,0,-165
20209,0,0,16,0,-16
20210,1,1,207,1299,1092
20211,0,0,88,0,-88
20212,0,0,0,0,0
20213,1,0,12,0,-12
20214,1,1,1059,1648,589
20215,1,1,160,1700,1540
20216,0,0,24,0,-24
20217,1,1,1667,1376,-291
20218,1,1,725,1356,631
20219,1,0,26,0,-26
20220,1,0,1,0,-1
20221,1,1,275,1898,1623
20222,0,0,35,0,-35
20223,0,0,10,0,-10
20224,1,0,39,0,-39
20225,1,1,355,2132,1777
20226,1,0,37,0,-37
20227,1,1,172,1596,1424
20228,1,0,20,0,-20
20229,0,0,151,0,-151
20230,0,0,3,0,-3
20231,0,0,23,0,-23
20232,1,1,62,1203,1141
20233,0,0,36,0,-36
20234,1,0,85,0,-85
20235,1,1,178,1545,1367
20236,0,0,59,0,-59
20237,1,0,36,0,-36
20238,1,0,25,0,-25
20239,0,0,16,0,-16
20240,1,0,48,0,-48
20241,1,0,42,0,-42
20242,1,1,702,1838,1136
20243,0,0,48,0,-48
20244,1,1,48,2696,2648
20245,1,0,94,0,-94
20246,1,0,29,0,-29
20247,1,0,185,0,-185
20248,1,0,23,0,-23
20249,1,0,66,0,-66
20250,1,0,15,0,-15
20251,0,0,10,0,-10
20252,0,0,97,0,-97
20253,0,0,53,0,-53
20254,1,0,56,0,-56
20255,0,0,34,0,-34
20256,1,1,271,1332,1061
20257,0,0,21,0,-21
20258,1,1,166,1295,1129
20259,1,0,5,0,-5
20260,1,0,15,0,-15
20261,0,0,127,0,-127
20262,1,0,192,0,-192
20263,1,0,65,0,-65
20264,0,0,47,0,-47
20265,1,0,11,0,-11
20266,1,0,7,0,-7
20267,0,0,61,0,-61
20268,0,0,75,0,-75
20269,1,0,112,0,-112
20270,1,0,0,0,0
20271,0,0,19,0,-19
20272,0,0,2,0,-2
20273,0,0,183,0,-183
20274,0,0,134,0,-134
20275,0,0,11,0,-11
20276,1,1,238,1418,1180
20277,1,1,266,1503,1237
20278,1,1,208,1200,992
20279,1,0,5,0,-5
20280,1,1,337,1315,978
20281,1,1,57,1570,1513
20282,1,1,197,1277,1080
20283,0,0,233,0,-233
20284,0,0,38,0,-38
20285,0,0,84,0,-84
20286,1,1,221,1270,1049
20287,1,1,112,2482,2370
20288,1,0,23,0,-23
20289,1,1,1142,1517,375
20290,1,0,60,0,-60
20291,0,0,41,0,-41
20292,1,0,29,0,-29
20293,1,1,161,2757,2596
20294,0,0,2,0,-2
20295,1,0,10,0,-10
20296,0,0,23,0,-23
20297,1,1,849,1462,613
20298,0,0,62,0,-62
20299,0,0,168,0,-168
20300,1,1,1130,1455,325
20301,1,1,838,1436,598
20302,1,1,199,2838,2639
20303,1,1,58,1205,1147
20304,1,1,137,1508,1371
20305,1,0,75,0,-75
20306,1,1,96,1260,1164
20307,0,0,8,0,-8
20308,0,0,34,0,-34
20309,1,1,1051,1307,256
20310,1,1,199,1676,1477
20311,1,0,32,0,-32
20312,0,0,83,0,-83
20313,1,0,7,0,-7
20314,0,0,67,0,-67
20315,0,0,19,0,-19
20316,1,1,695,1247,552
20317,1,1,94,1361,1267
20318,1,0,10,0,-10
20319,1,0,42,0,-42
20320,0,0,55,0,-55
20321,0,0,62,0,-62
20322,1,1,414,1202,788
20323,1,1,339,1523,1184
20324,1,0,74,0,-74
20325,1,0,56,0,-56
20326,0,0,126,0,-126
20327,1,0,22,0,-22
20328,1,0,62,0,-62
20329,0,0,5,0,-5
20330,1,0,83,0,-83
20331,1,1,226,1403,1177
20332,1,0,20,0,-20
20333,1,1,902,1232,330
20334,0,0,14,0,-14
20335,1,0,44,0,-44
20336,0,0,132,0,-132
20337,1,0,17,0,-17
20338,0,0,70,0,-70
20339,1,1,84,2122,2038
20340,1,1,910,1276,366
20341,1,1,126,1379,1253
20342,1,0,55,0,-55
20343,0,0,35,0,-35
20344,1,0,75,0,-75
20345,0,0,13,0,-13
20346,0,0,30,0,-30
20347,0,0,31,0,-31
20348,0,0,40,0,-40
20349,1,0,33,0,-33
20350,1,1,116,1408,1292
20351,1,0,3,0,-3
20352,1,0,6,0,-6
20353,0,0,28,0,-28
20354,0,0,75,0,-75
20355,0,0,3,0,-3
20356,1,0,20,0,-20
20357,1,1,198,3039,2841
20358,1,1,294,1486,1192
20359,0,0,58,0,-58
20360,1,1,353,1480,1127
20361,1,1,539,1840,1301
20362,1,0,63,0,-63
20363,1,1,322,1995,1673
20364,1,1,75,1409,1334
20365,0,0,13,0,-13
20366,1,0,166,0,-166
20367,1,1,1980,1219,-761
20368,0,0,74,0,-74
20369,1,0,101,0,-101
20370,1,0,26,0,-26
20371,0,0,33,0,-33
20372,0,0,1,0,-1
20373,1,0,30,0,-30
20374,1,0,3,0,-3
20375,0,0,105,0,-105
20376,0,0,73,0,-73
20377,1,0,159,0,-159
20378,0,0,14,0,-14
20379,1,1,592,1516,924
20380,1,1,97,1653,1556
20381,0,0,39,0,-39
20382,1,0,0,0,0
20383,1,1,611,1455,844
20384,0,0,22,0,-22
20385,0,0,35,0,-35
20386,1,0,74,0,-74
20387,1,0,12,0,-12
20388,1,0,28,0,-28
20389,0,0,3,0,-3
20390,1,0,54,0,-54
20391,0,0,20,0,-20
20392,1,0,2,0,-2
20393,0,0,92,0,-92
20394,1,0,18,0,-18
20395,1,0,4,0,-4
20396,1,0,41,0,-41
20397,1,1,59,1797,1738
20398,0,0,25,0,-25
20399,0,0,34,0,-34
20400,1,0,22,0,-22
20401,1,0,71,0,-71
20402,0,0,66,0,-66
20403,1,0,36,0,-36
20404,1,0,40,0,-40
20405,1,0,51,0,-51
20406,1,1,511,3210,2699
20407,0,0,1,0,-1
20408,0,0,16,0,-16
20409,1,1,712,1705,993
20410,1,0,66,0,-66
20411,1,0,14,0,-14
20412,1,1,910,1335,425
20413,0,0,1,0,-1
20414,1,1,513,1283,770
20415,0,0,18,0,-18
20416,1,1,861,1243,382
20417,1,1,1360,1384,24
20418,1,0,75,0,-75
20419,1,1,89,1583,1494
20420,0,0,25,0,-25
20421,1,0,1,0,-1
20422,1,1,483,1250,767
20423,0,0,46,0,-46
20424,1,0,5,0,-5
20425,1,1,1575,1349,-226
20426,0,0,4,0,-4
20427,0,0,20,0,-20
20428,0,0,70,0,-70
20429,0,0,3,0,-3
20430,0,0,0,0,0
20431,0,0,13,0,-13
20432,1,0,83,0,-83
20433,1,1,82,1440,1358
20434,0,0,167,0,-167
20435,1,0,12,0,-12
20436,0,0,297,0,-297
20437,1,1,302,1592,1290
20438,1,0,111,0,-111
20439,1,1,1023,1287,264
20440,0,0,23,0,-23
20441,1,1,503,1317,814
20442,1,0,9,0,-9
20443,0,0,7,0,-7
20444,0,0,235,0,-235
20445,1,0,38,0,-38
20446,1,0,16,0,-16
20447,1,0,94,0,-94
20448,0,0,19,0,-19
20449,1,1,360,2682,2322
20450,1,0,37,0,-37
20451,0,0,175,0,-175
20452,1,0,12,0,-12
20453,1,1,250,1649,1399
20454,1,1,106,1220,1114
20455,1,1,623,1248,625
20456,1,1,123,1328,1205
20457,1,1,160,1522,1362
20458,1,0,15,0,-15
20459,0,0,56,0,-56
20460,1,1,909,1725,816
20461,1,0,13,0,-13
20462,0,0,22,0,-22
20463,1,0,28,0,-28
20464,1,1,390,1243,853
20465,0,0,17,0,-17
20466,1,1,1298,1691,393
20467,1,1,1136,1882,746
20468,0,0,31,0,-31
20469,0,0,35,0,-35
20470,1,0,46,0,-46
20471,1,0,43,0,-43
20472,1,1,1148,1543,395
20473,1,0,28,0,-28
20474,1,0,82,0,-82
20475,0,0,47,0,-47
20476,1,0,143,0,-143
20477,1,0,24,0,-24
20478,1,1,38,1681,1643
20479,0,0,6,0,-6
20480,1,1,231,1449,1218
20481,1,0,68,0,-68
20482,1,0,33,0,-33
20483,1,0,25,0,-25
20484,0,0,8,0,-8
20485,1,0,30,0,-30
20486,1,0,31,0,-31
20487,1,0,25,0,-25
20488,1,0,8,0,-8
20489,1,0,16,0,-16
20490,1,0,77,0,-77
20491,1,1,95,2051,1956
20492,1,0,50,0,-50
20493,1,1,167,1335,1168
20494,0,0,56,0,-56
20495,1,0,16,0,-16
20496,1,1,915,1449,534
20497,1,1,123,1297,1174
20498,1,1,357,1276,919
20499,0,0,94,0,-94
20500,0,0,18,0,-18
20501,0,0,15,0,-15
20502,1,0,49,0,-49
20503,1,1,411,1245,834
20504,1,0,29,0,-29
20505,1,0,239,0,-239
20506,1,1,1086,1206,120
20507,0,0,150,0,-150
20508,1,1,599,1232,633
20509,1,1,886,1479,593
20510,0,0,19,0,-19
20511,0,0,80,0,-80
20512,0,0,13,0,-13
20513,0,0,56,0,-56
20514,1,1,135,1445,1310
20515,1,0,27,0,-27
20516,1,0,69,0,-69
20517,1,0,26,0,-26
20518,1,0,33,0,-33
20519,1,1,1610,1347,-263
20520,1,1,90,1677,1587
20521,1,0,15,0,-15
20522,0,0,43,0,-43
20523,1,0,0,0,0
20524,1,1,557,1660,1103
20525,1,1,68,2044,1976
20526,1,0,6,0,-6
20527,0,0,17,0,-17
20528,0,0,3,0,-3
20529,0,0,33,0,-33
20530,0,0,40,0,-40
20531,1,1,19,2076,2057
20532,0,0,23,0,-23
20533,0,0,55,0,-55
20534,0,0,77,0,-77
20535,0,0,14,0,-14
20536,1,1,505,1224,719
20537,0,0,35,0,-35
20538,1,0,91,0,-91
20539,0,0,13,0,-13
20540,0,0,94,0,-94
20541,1,1,201,1951,1750
20542,0,0,69,0,-69
20543,1,0,76,0,-76
20544,0,0,18,0,-18
20545,1,0,54,0,-54
20546,1,1,629,2118,1489
20547,0,0,36,0,-36
20548,1,0,47,0,-47
20549,0,0,24,0,-24
20550,0,0,4,0,-4
20551,1,1,861,1588,727
20552,0,0,12,0,-12
20553,1,1,302,1563,1261
20554,1,1,194,1288,1094
20555,1,1,296,1528,1232
20556,1,1,838,3099,2261
20557,0,0,140,0,-140
20558,0,0,12,0,-12
20559,0,0,0,0,0
20560,1,1,377,1294,917
20561,0,0,48,0,-48
20562,1,0,15,0,-15
20563,0,0,18,0,-18
20564,0,0,12,0,-12
20565,0,0,32,0,-32
20566,0,0,17,0,-17
20567,1,1,148,1345,1197
20568,0,0,29,0,-29
20569,1,1,65,1679,1614
20570,0,0,60,0,-60
20571,1,0,128,0,-128
20572,1,0,73,0,-73
20573,1,1,20,1245,1225
20574,0,0,114,0,-114
20575,1,1,139,1218,1079
20576,1,1,129,1403,1274
20577,1,1,291,1347,1056
20578,1,0,2,0,-2
20579,1,0,32,0,-32
20580,1,1,146,1619,1473
20581,0,0,70,0,-70
20582,0,0,2,0,-2
20583,1,0,15,0,-15
20584,0,0,35,0,-35
20585,1,0,15,0,-15
20586,0,0,4,0,-4
20587,0,0,5,0,-5
20588,1,0,113,0,-113
20589,1,1,352,1271,919
20590,0,0,31,0,-31
20591,1,1,876,1455,579
20592,0,0,0,0,0
20593,1,0,31,0,-31
20594,1,1,633,1240,607
20595,0,0,87,0,-87
20596,0,0,17,0,-17
20597,1,1,120,1238,1118
20598,0,0,65,0,-65
20599,0,0,70,0,-70
20600,1,1,332,1462,1130
20601,1,1,447,1317,870
20602,0,0,5,0,-5
20603,0,0,4,0,-4
20604,1,0,31,0,-31
20605,0,0,61,0,-61
20606,1,1,1185,1318,133
20607,1,1,321,1277,956
20608,1,1,683,1219,536
20609,1,0,33,0,-33
20610,1,1,725,1430,705
20611,1,1,177,1732,1555
20612,1,0,61,0,-61
20613,1,1,129,1799,1670
20614,0,0,13,0,-13
20615,1,0,25,0,-25
20616,0,0,19,0,-19
20617,0,0,5,0,-5
20618,1,0,33,0,-33
20619,1,0,109,0,-109
20620,1,0,29,0,-29
20621,1,1,234,1889,1655
20622,1,0,4,0,-4
20623,1,0,30,0,-30
20624,0,0,67,0,-67
20625,0,0,19,0,-19
20626,0,0,3,0,-3
20627,1,0,32,0,-32
20628,1,1,437,1209,772
20629,0,0,27,0,-27
20630,0,0,10,0,-10
20631,1,1,440,1381,941
20632,0,0,17,0,-17
20633,1,0,44,0,-44
20634,0,0,4,0,-4
20635,0,0,98,0,-98
20636,1,0,113,0,-113
20637,1,0,46,0,-46
20638,0,0,19,0,-19
20639,0,0,16,0,-16
20640,0,0,9,0,-9
20641,0,0,27,0,-27
20642,0,0,157,0,-157
20643,1,0,47,0,-47
20644,1,0,32,0,-32
20645,0,0,8,0,-8
20646,0,0,34,0,-34
20647,0,0,183,0,-183
20648,0,0,9,0,-9
20649,0,0,25,0,-25
20650,1,1,258,1723,1465
20651,1,1,1051,1330,279
20652,1,0,62,0,-62
20653,1,1,131,1570,1439
20654,0,0,16,0,-16
20655,0,0,23,0,-23
20656,1,0,90,0,-90
20657,0,0,45,0,-45
20658,0,0,4,0,-4
20659,0,0,52,0,-52
20660,1,0,9,0,-9
20661,0,0,203,0,-203
20662,1,1,256,1560,1304
20663,1,1,514,1209,695
20664,1,1,238,1259,1021
20665,1,0,19,0,-19
20666,1,0,28,0,-28
20667,1,0,74,0,-74
20668,1,0,12,0,-12
20669,0,0,4,0,-4
20670,0,0,56,0,-56
20671,0,0,94,0,-94
20672,0,0,105,0,-105
20673,0,0,45,0,-45
20674,1,1,108,1886,1778
20675,0,0,24,0,-24
20676,1,1,68,1308,1240
20677,0,0,4,0,-4
20678,0,0,59,0,-59
20679,0,0,63,0,-63
20680,1,0,23,0,-23
20681,0,0,19,0,-19
20682,1,1,633,1210,577
20683,0,0,41,0,-41
20684,0,0,70,0,-70
20685,0,0,60,0,-60
20686,0,0,32,0,-32
20687,1,1,324,1399,1075
20688,0,0,55,0,-55
20689,1,1,534,1268,734
20690,1,0,98,0,-98
20691,1,0,102,0,-102
20692,1,1,61,1220,1159
20693,0,0,21,0,-21
20694,0,0,210,0,-210
20695,1,0,7,0,-7
20696,1,0,50,0,-50
20697,0,0,61,0,-61
20698,0,0,32,0,-32
20699,0,0,133,0,-133
20700,1,0,72,0,-72
20701,0,0,31,0,-31
20702,1,0,33,0,-33
20703,0,0,106,0,-106
20704,1,1,323,1401,1078
20705,1,0,64,0,-64
20706,1,0,41,0,-41
20707,1,0,62,0,-62
20708,1,0,59,0,-59
20709,1,1,1579,1210,-369
20710,1,1,674,1323,649
20711,0,0,24,0,-24
20712,0,0,49,0,-49
20713,1,0,16,0,-16
20714,1,1,515,1442,927
20715,0,0,33,0,-33
20716,1,0,57,0,-57
20717,0,0,4,0,-4
20718,1,1,409,1395,986
20719,1,0,13,0,-13
20720,1,0,0,0,0
20721,1,0,12,0,-12
20722,1,0,5,0,-5
20723,1,0,11,0,-11
20724,0,0,0,0,0
20725,1,0,35,0,-35
20726,0,0,28,0,-28
20727,1,0,96,0,-96
20728,1,1,799,1948,1149
20729,1,0,21,0,-21
20730,1,1,977,1207,230
20731,1,0,49,0,-49
20732,1,0,86,0,-86
20733,1,1,202,1545,1343
20734,0,0,50,0,-50
20735,1,1,78,1315,1237
20736,0,0,52,0,-52
20737,1,1,763,2467,1704
20738,0,0,8,0,-8
20739,0,0,21,0,-21
20740,0,0,49,0,-49
20741,0,0,5,0,-5
20742,0,0,33,0,-33
20743,1,1,45,1242,1197
20744,0,0,129,0,-129
20745,0,0,25,0,-25
20746,1,1,103,1968,1865
20747,1,1,679,1686,1007
20748,0,0,41,0,-41
20749,0,0,6,0,-6
20750,1,0,129,0,-129
20751,1,0,45,0,-45
20752,1,0,16,0,-16
20753,1,1,460,1244,784
20754,1,1,240,1475,1235
20755,0,0,25,0,-25
20756,1,1,514,1315,801
20757,0,0,106,0,-106
20758,0,0,2,0,-2
20759,1,1,322,1554,1232
20760,0,0,9,0,-9
20761,1,1,161,2156,1995
20762,1,0,18,0,-18
20763,1,0,49,0,-49
20764,0,0,45,0,-45
20765,1,0,1,0,-1
20766,1,1,107,1307,1200
20767,1,1,1256,1400,144
20768,1,1,155,1713,1558
20769,1,0,41,0,-41
20770,1,0,11,0,-11
20771,0,0,93,0,-93
20772,1,1,693,1398,705
20773,1,1,124,1299,1175
20774,1,0,60,0,-60
20775,0,0,72,0,-72
20776,1,1,68,1799,1731
20777,0,0,45,0,-45
20778,1,0,13,0,-13
20779,0,0,33,0,-33
20780,1,0,69,0,-69
20781,1,0,13,0,-13
20782,1,1,814,1557,743
20783,0,0,44,0,-44
20784,0,0,112,0,-112
20785,1,0,50,0,-50
20786,1,0,40,0,-40
20787,1,0,21,0,-21
20788,0,0,16,0,-16
20789,1,1,72,1557,1485
20790,1,1,28,1337,1309
20791,0,0,62,0,-62
20792,0,0,110,0,-110
20793,1,0,91,0,-91
20794,1,0,26,0,-26
20795,0,0,3,0,-3
20796,0,0,54,0,-54
20797,1,1,82,1614,1532
20798,1,0,141,0,-141
20799,1,1,177,1310,1133
20800,1,0,6,0,-6
20801,1,1,95,1332,1237
20802,0,0,87,0,-87
20803,0,0,1,0,-1
20804,0,0,113,0,-113
20805,1,0,47,0,-47
20806,1,1,428,1788,1360
20807,1,0,11,0,-11
20808,1,0,21,0,-21
20809,1,0,112,0,-112
20810,1,0,11,0,-11
20811,1,1,235,1574,1339
20812,0,0,96,0,-96
20813,1,1,660,2693,2033
20814,1,0,1,0,-1
20815,0,0,100,0,-100
20816,0,0,52,0,-52
20817,1,1,63,3180,3117
20818,0,0,1,0,-1
20819,0,0,14,0,-14
20820,1,0,89,0,-89
20821,0,0,92,0,-92
20822,0,0,11,0,-11
20823,0,0,92,0,-92
20824,1,1,394,1437,1043
20825,0,0,0,0,0
20826,1,1,264,1697,1433
20827,0,0,38,0,-38
20828,1,1,889,1216,327
20829,1,1,30,1318,1288
20830,0,0,16,0,-16
20831,0,0,28,0,-28
20832,1,0,29,0,-29
20833,1,0,11,0,-11
20834,0,0,15,0,-15
20835,0,0,25,0,-25
20836,1,0,68,0,-68
20837,0,0,17,0,-17
20838,0,0,130,0,-130
20839,1,1,475,1818,1343
20840,1,0,14,0,-14
20841,0,0,69,0,-69
20842,1,0,68,0,-68
20843,0,0,5,0,-5
20844,0,0,24,0,-24
20845,0,0,6,0,-6
20846,1,1,100,1807,1707
20847,1,1,426,1581,1155
20848,0,0,0,0,0
20849,1,1,631,2170,1539
20850,0,0,62,0,-62
20851,0,0,59,0,-59
20852,1,1,252,1717,1465
20853,1,0,38,0,-38
20854,1,1,399,1259,860
20855,0,0,107,0,-107
20856,0,0,38,0,-38
20857,1,0,7,0,-7
20858,1,1,1002,1960,958
20859,1,0,89,0,-89
20860,1,0,104,0,-104
20861,0,0,224,0,-224
20862,1,1,967,1258,291
20863,0,0,75,0,-75
20864,1,0,106,0,-106
20865,0,0,13,0,-13
20866,1,1,846,1200,354
20867,1,0,13,0,-13
20868,0,0,29,0,-29
20869,1,0,45,0,-45
20870,1,0,4,0,-4
20871,1,1,1097,2374,1277
20872,1,1,126,1345,1219
20873,1,0,8,0,-8
20874,1,1,343,1982,1639
20875,1,1,337,1627,1290
20876,0,0,8,0,-8
20877,1,0,66,0,-66
20878,0,0,198,0,-198
20879,1,1,22,1285,1263
20880,0,0,7,0,-7
20881,1,1,402,2727,2325
20882,1,0,5,0,-5
20883,1,1,57,1369,1312
20884,0,0,26,0,-26
20885,0,0,77,0,-77
20886,1,1,574,1295,721
20887,0,0,58,0,-58
20888,1,1,446,2119,1673
20889,0,0,9,0,-9
20890,0,0,82,0,-82
20891,1,0,28,0,-28
20892,1,0,113,0,-113
20893,1,0,75,0,-75
20894,1,0,6,0,-6
20895,0,0,83,0,-83
20896,1,1,556,1238,682
20897,0,0,10,0,-10
20898,1,1,664,1705,1041
20899,1,0,43,0,-43
20900,1,1,86,1225,1139
20901,0,0,29,0,-29
20902,0,0,15,0,-15
20903,0,0,47,0,-47
20904,0,0,6,0,-6
20905,1,1,646,1291,645
20906,1,1,1362,1535,173
20907,1,1,532,1337,805
20908,1,0,111,0,-111
20909,1,0,12,0,-12
20910,1,0,15,0,-15
20911,1,0,58,0,-58
20912,0,0,9,0,-9
20913,1,1,512,2461,1949
20914,0,0,70,0,-70
20915,1,0,43,0,-43
20916,0,0,19,0,-19
20917,1,0,62,0,-62
20918,0,0,62,0,-62
20919,0,0,182,0,-182
20920,1,1,588,1242,654
20921,1,0,53,0,-53
20922,0,0,14,0,-14
20923,1,0,67,0,-67
20924,0,0,9,0,-9
20925,0,0,31,0,-31
20926,0,0,18,0,-18
20927,1,0,24,0,-24
20928,0,0,33,0,-33
20929,1,1,413,1914,1501
20930,0,0,19,0,-19
20931,0,0,89,0,-89
20932,0,0,9,0,-9
20933,1,0,24,0,-24
20934,1,1,1655,2586,931
20935,0,0,85,0,-85
20936,0,0,176,0,-176
20937,1,1,527,1330,803
20938,0,0,24,0,-24
20939,1,0,78,0,-78
20940,1,0,44,0,-44
20941,1,0,27,0,-27
20942,0,0,85,0,-85
20943,1,0,100,0,-100
20944,1,1,164,1464,1300
20945,1,1,310,1338,1028
20946,0,0,178,0,-178
20947,1,1,497,1205,708
20948,1,0,37,0,-37
20949,1,1,393,1342,949
20950,0,0,7,0,-7
20951,1,1,378,1384,1006
20952,0,0,63,0,-63
20953,0,0,22,0,-22
20954,1,1,179,1260,1081
20955,1,1,975,1284,309
20956,0,0,66,0,-66
20957,1,0,40,0,-40
20958,1,1,643,1336,693
20959,1,1,420,1697,1277
20960,1,1,1412,1226,-186
20961,1,1,132,1482,1350
20962,0,0,53,0,-53
20963,0,0,10,0,-10
20964,1,0,149,0,-149
20965,1,0,57,0,-57
20966,1,0,83,0,-83
20967,1,0,5,0,-5
20968,1,0,132,0,-132
20969,1,1,1540,1537,-3
20970,0,0,51,0,-51
20971,1,0,13,0,-13
20972,0,0,22,0,-22
20973,1,0,34,0,-34
20974,0,0,22,0,-22
20975,0,0,8,0,-8
20976,0,0,92,0,-92
20977,1,1,986,1262,276
20978,0,0,17,0,-17
20979,1,1,1095,1706,611
20980,0,0,17,0,-17
20981,0,0,4,0,-4
20982,1,1,644,2773,2129
20983,0,0,7,0,-7
20984,0,0,10,0,-10
20985,1,1,520,1233,713
20986,1,1,1314,1255,-59
20987,0,0,13,0,-13
20988,1,1,173,1221,1048
20989,0,0,41,0,-41
20990,1,1,269,1235,966
20991,0,0,156,0,-156
20992,1,0,57,0,-57
20993,1,0,4,0,-4
20994,1,1,385,1343,958
20995,1,0,21,0,-21
20996,1,1,462,1338,876
20997,0,0,5,0,-5
20998,0,0,2,0,-2
20999,0,0,31,0,-31
21000,0,0,90,0,-90
21001,1,0,37,0,-37
21002,1,0,38,0,-38
21003,0,0,35,0,-35
21004,1,1,204,1317,1113
21005,0,0,48,0,-48
21006,0,0,72,0,-72
21007,0,0,114,0,-114
21008,1,0,0,0,0
21009,1,1,517,1563,1046
21010,0,0,7,0,-7
21011,0,0,88,0,-88
21012,0,0,94,0,-94
21013,1,1,124,1303,1179
21014,0,0,5,0,-5
21015,1,0,82,0,-82
21016,0,0,6,0,-6
21017,1,1,358,1462,1104
21018,0,0,229,0,-229
21019,0,0,16,0,-16
21020,1,1,547,3156,2609
21021,0,0,39,0,-39
21022,1,0,76,0,-76
21023,1,0,5,0,-5
21024,1,0,90,0,-90
21025,1,1,270,1313,1043
21026,1,1,187,1241,1054
21027,0,0,202,0,-202
21028,1,1,272,1275,1003
21029,0,0,50,0,-50
21030,1,1,682,1600,918
21031,1,1,1759,1262,-497
21032,0,0,302,0,-302
21033,0,0,24,0,-24
21034,0,0,7,0,-7
21035,0,0,32,0,-32
21036,0,0,3,0,-3
21037,1,0,97,0,-97
21038,0,0,17,0,-17
21039,0,0,3,0,-3
21040,1,0,42,0,-42
21041,1,0,33,0,-33
21042,0,0,30,0,-30
21043,1,1,117,1429,1312
21044,1,0,123,0,-123
21045,0,0,42,0,-42
21046,0,0,22,0,-22
21047,0,0,39,0,-39
21048,1,1,253,1315,1062
21049,0,0,8,0,-8
21050,1,0,57,0,-57
21051,0,0,36,0,-36
21052,1,0,63,0,-63
21053,0,0,7,0,-7
21054,1,1,315,1388,1073
21055,1,1,554,1397,843
21056,1,0,23,0,-23
21057,1,1,884,1752,868
21058,0,0,86,0,-86
21059,1,0,26,0,-26
21060,1,1,776,1833,1057
21061,1,0,78,0,-78
21062,1,1,402,1417,1015
21063,1,1,804,2525,1721
21064,0,0,16,0,-16
21065,0,0,36,0,-36
21066,0,0,39,0,-39
21067,1,0,78,0,-78
21068,0,0,3,0,-3
21069,1,0,200,0,-200
21070,1,1,955,1245,290
21071,1,0,37,0,-37
21072,0,0,24,0,-24
21073,0,0,52,0,-52
21074,1,0,13,0,-13
21075,0,0,44,0,-44
21076,0,0,48,0,-48
21077,1,1,515,1541,1026
21078,0,0,174,0,-174
21079,0,0,8,0,-8
21080,0,0,12,0,-12
21081,1,1,604,1709,1105
21082,1,0,76,0,-76
21083,0,0,103,0,-103
21084,0,0,109,0,-109
21085,1,1,792,1206,414
21086,1,1,968,1368,400
21087,1,0,27,0,-27
21088,0,0,85,0,-85
21089,1,1,297,1510,1213
21090,1,1,383,1284,901
21091,0,0,31,0,-31
21092,1,0,26,0,-26
21093,0,0,134,0,-134
21094,1,1,183,1560,1377
21095,1,0,3,0,-3
21096,1,1,103,1390,1287
21097,0,0,21,0,-21
21098,1,0,42,0,-42
21099,1,1,542,1850,1308
21100,1,1,88,2445,2357
21101,1,1,141,1203,1062
21102,0,0,114,0,-114
21103,1,1,664,1730,1066
21104,1,1,227,1951,1724
21105,1,0,120,0,-120
21106,1,1,578,1469,891
21107,1,1,1561,1233,-328
21108,1,1,389,1270,881
21109,1,1,156,1555,1399
21110,0,0,5,0,-5
21111,0,0,54,0,-54
21112,1,0,38,0,-38
21113,1,0,23,0,-23
21114,1,1,1045,1572,527
21115,0,0,42,0,-42
21116,1,1,32,1244,1212
21117,1,0,8,0,-8
21118,1,0,11,0,-11
21119,1,0,46,0,-46
21120,1,1,812,1358,546
21121,1,1,431,2842,2411
21122,0,0,51,0,-51
21123,1,0,20,0,-20
21124,1,1,890,2580,1690
21125,1,1,145,2004,1859
21126,1,0,80,0,-80
21127,1,0,98,0,-98
21128,0,0,8,0,-8
21129,0,0,13,0,-13
21130,0,0,75,0,-75
21131,0,0,161,0,-161
21132,0,0,67,0,-67
21133,1,0,90,0,-90
21134,1,0,182,0,-182
21135,1,1,542,1607,1065
21136,1,1,384,2007,1623
21137,0,0,10,0,-10
21138,1,1,260,1843,1583
21139,1,0,139,0,-139
21140,1,1,170,1252,1082
21141,1,0,36,0,-36
21142,0,0,77,0,-77
21143,1,0,16,0,-16
21144,1,0,10,0,-10
21145,0,0,5,0,-5
21146,1,0,10,0,-10
21147,0,0,15,0,-15
21148,1,1,377,1206,829
21149,1,0,98,0,-98
21150,0,0,49,0,-49
21151,0,0,129,0,-129
21152,0,0,16,0,-16
21153,0,0,11,0,-11
21154,1,0,78,0,-78
21155,1,1,265,1203,938
21156,1,0,37,0,-37
21157,1,1,168,1728,1560
21158,1,1,809,1208,399
21159,0,0,60,0,-60
21160,0,0,94,0,-94
21161,0,0,3,0,-3
21162,0,0,80,0,-80
21163,0,0,55,0,-55
21164,1,1,51,1398,1347
21165,1,1,106,1236,1130
21166,1,1,1148,1502,354
21167,1,1,104,1965,1861
21168,1,0,22,0,-22
21169,1,1,607,1502,895
21170,0,0,4,0,-4
21171,0,0,0,0,0
21172,1,0,114,0,-114
21173,0,0,14,0,-14
21174,0,0,43,0,-43
21175,0,0,100,0,-100
21176,1,1,1202,1327,125
21177,1,1,216,1642,1426
21178,1,1,238,1686,1448
21179,0,0,154,0,-154
21180,0,0,2,0,-2
21181,1,0,123,0,-123
21182,0,0,79,0,-79
21183,1,1,353,1254,901
21184,0,0,0,0,0
21185,0,0,37,0,-37
21186,1,0,0,0,0
21187,1,0,61,0,-61
21188,0,0,11,0,-11
21189,0,0,87,0,-87
21190,1,1,242,1291,1049
21191,1,0,8,0,-8
21192,1,1,405,2013,1608
21193,1,1,326,1501,1175
21194,1,1,460,1341,881
21195,0,0,52,0,-52
21196,1,0,28,0,-28
21197,1,1,305,1436,1131
21198,1,1,401,1517,1116
21199,1,0,47,0,-47
21200,1,0,47,0,-47
21201,1,1,276,2152,1876
21202,1,1,303,1513,1210
21203,1,0,24,0,-24
21204,0,0,29,0,-29
21205,0,0,31,0,-31
21206,0,0,9,0,-9
21207,1,0,1,0,-1
21208,0,0,27,0,-27
21209,0,0,11,0,-11
21210,1,1,517,1531,1014
21211,0,0,108,0,-108
21212,1,1,232,1217,985
21213,0,0,22,0,-22
21214,0,0,18,0,-18
21215,1,1,130,1210,1080
21216,0,0,114,0,-114
21217,1,0,158,0,-158
21218,1,0,18,0,-18
21219,0,0,52,0,-52
21220,0,0,14,0,-14
21221,1,0,12,0,-12
21222,0,0,28,0,-28
21223,1,0,9,0,-9
21224,1,1,153,1272,1119
21225,1,0,52,0,-52
21226,1,1,294,1627,1333
21227,1,0,62,0,-62
21228,1,0,160,0,-160
21229,1,0,46,0,-46
21230,0,0,52,0,-52
21231,1,1,42,1236,1194
21232,1,1,311,1620,1309
21233,0,0,123,0,-123
21234,0,0,21,0,-21
21235,1,1,297,1510,1213
21236,1,0,4,0,-4
21237,0,0,7,0,-7
21238,0,0,88,0,-88
21239,0,0,94,0,-94
21240,1,0,82,0,-82
21241,1,0,80,0,-80
21242,1,0,104,0,-104
21243,1,0,24,0,-24
21244,0,0,3,0,-3
21245,0,0,40,0,-40
21246,0,0,72,0,-72
21247,0,0,16,0,-16
21248,1,0,50,0,-50
21249,1,0,34,0,-34
21250,1,0,235,0,-235
21251,0,0,49,0,-49
21252,1,1,55,1349,1294
21253,1,1,821,1600,779
21254,0,0,7,0,-7
21255,1,1,55,1610,1555
21256,0,0,95,0,-95
21257,1,0,45,0,-45
21258,0,0,18,0,-18
21259,1,1,577,1516,939
21260,0,0,15,0,-15
21261,0,0,98,0,-98
21262,1,1,473,2923,2450
21263,1,1,1298,1448,150
21264,1,0,23,0,-23
21265,1,1,195,1572,1377
21266,1,1,517,1282,765
21267,1,1,589,1899,1310
21268,1,1,82,1206,1124
21269,1,0,104,0,-104
21270,1,1,24,1225,1201
21271,1,0,71,0,-71
21272,0,0,22,0,-22
21273,1,0,11,0,-11
21274,1,1,172,2595,2423
21275,1,0,27,0,-27
21276,1,0,92,0,-92
21277,0,0,145,0,-145
21278,0,0,21,0,-21
21279,1,0,4,0,-4
21280,1,0,55,0,-55
21281,1,1,1580,1762,182
21282,1,0,50,0,-50
21283,0,0,3,0,-3
21284,1,1,133,1334,1201
21285,1,1,1114,1973,859
21286,1,1,261,1312,1051
21287,1,1,897,1232,335
21288,1,1,75,1278,1203
21289,1,1,851,1384,533
21290,0,0,1,0,-1
21291,0,0,18,0,-18
21292,0,0,47,0,-47
21293,0,0,5,0,-5
21294,1,0,51,0,-51
21295,0,0,149,0,-149
21296,0,0,76,0,-76
21297,1,1,1071,1200,129
21298,1,1,135,1369,1234
21299,1,1,253,1662,1409
21300,0,0,2,0,-2
21301,1,0,37,0,-37
21302,1,0,30,0,-30
21303,1,1,86,1432,1346
21304,0,0,191,0,-191
21305,1,0,5,0,-5
21306,1,0,21,0,-21
21307,1,0,4,0,-4
21308,1,1,177,2184,2007
21309,0,0,40,0,-40
21310,1,1,5,1247,1242
21311,1,1,72,1567,1495
21312,1,1,95,1338,1243
21313,1,1,31,2047,2016
21314,0,0,148,0,-148
21315,0,0,66,0,-66
21316,1,1,1608,1631,23
21317,1,1,535,2209,1674
21318,1,0,12,0,-12
21319,0,0,4,0,-4
21320,1,1,152,1446,1294
21321,0,0,18,0,-18
21322,1,1,370,1882,1512
21323,1,1,113,1319,1206
21324,1,0,81,0,-81
21325,1,0,67,0,-67
21326,1,0,7,0,-7
21327,1,0,15,0,-15
21328,1,1,1010,1302,292
21329,1,0,57,0,-57
21330,1,0,23,0,-23
21331,0,0,43,0,-43
21332,1,0,11,0,-11
21333,1,1,417,2655,2238
21334,1,1,507,1255,748
21335,1,1,324,1283,959
21336,0,0,21,0,-21
21337,0,0,114,0,-114
21338,1,0,10,0,-10
21339,1,0,10,0,-10
21340,0,0,31,0,-31
21341,1,0,67,0,-67
21342,1,1,283,2046,1763
21343,0,0,17,0,-17
21344,1,0,78,0,-78
21345,0,0,83,0,-83
21346,0,0,2,0,-2
21347,1,1,372,1328,956
21348,1,0,133,0,-133
21349,1,1,772,1644,872
21350,1,1,1585,1527,-58
21351,1,1,88,1586,1498
21352,0,0,10,0,-10
21353,0,0,7,0,-7
21354,1,0,94,0,-94
21355,1,1,374,1233,859
21356,1,1,1219,1331,112
21357,0,0,7,0,-7
21358,1,0,16,0,-16
21359,1,0,72,0,-72
21360,0,0,32,0,-32
21361,1,0,10,0,-10
21362,1,1,411,1851,1440
21363,0,0,9,0,-9
21364,1,1,1558,1244,-314
21365,0,0,19,0,-19
21366,0,0,47,0,-47
21367,1,1,946,1399,453
21368,1,0,20,0,-20
21369,0,0,2,0,-2
21370,0,0,139,0,-139
21371,1,0,3,0,-3
21372,1,0,100,0,-100
21373,0,0,34,0,-34
21374,0,0,25,0,-25
21375,1,1,1959,1545,-414
21376,1,1,238,1396,1158
21377,1,0,7,0,-7
21378,1,1,537,1256,719
21379,0,0,1,0,-1
21380,0,0,35,0,-35
21381,0,0,8,0,-8
21382,0,0,64,0,-64
21383,1,1,774,1250,476
21384,1,0,61,0,-61
21385,0,0,34,0,-34
21386,1,0,150,0,-150
21387,0,0,80,0,-80
21388,1,0,56,0,-56
21389,1,0,20,0,-20
21390,1,1,1454,1317,-137
21391,0,0,14,0,-14
21392,0,0,222,0,-222
21393,1,1,702,1539,837
21394,1,1,174,1968,1794
21395,0,0,18,0,-18
21396,1,1,1132,2249,1117
21397,0,0,34,0,-34
21398,0,0,76,0,-76
21399,1,1,691,1718,1027
21400,1,0,7,0,-7
21401,1,0,6,0,-6
21402,1,0,113,0,-113
21403,0,0,126,0,-126
21404,0,0,5,0,-5
21405,0,0,92,0,-92
21406,1,1,716,1237,521
21407,1,0,180,0,-180
21408,1,1,798,1244,446
21409,0,0,44,0,-44
21410,0,0,20,0,-20
21411,0,0,9,0,-9
21412,1,0,163,0,-163
21413,0,0,10,0,-10
21414,1,0,2,0,-2
21415,0,0,19,0,-19
21416,1,1,167,2009,1842
21417,0,0,15,0,-15
21418,0,0,91,0,-91
21419,1,0,4,0,-4
21420,1,1,197,2019,1822
21421,1,0,74,0,-74
21422,1,0,14,0,-14
21423,1,0,77,0,-77
21424,1,1,291,1216,925
21425,0,0,29,0,-29
21426,0,0,4,0,-4
21427,1,0,15,0,-15
21428,1,1,784,1864,1080
21429,0,0,13,0,-13
21430,1,1,443,1660,1217
21431,0,0,12,0,-12
21432,0,0,20,0,-20
21433,1,0,19,0,-19
21434,0,0,19,0,-19
21435,1,1,325,1376,1051
21436,1,0,7,0,-7
21437,0,0,14,0,-14
21438,0,0,10,0,-10
21439,1,0,0,0,0
21440,1,1,172,1364,1192
21441,0,0,190,0,-190
21442,1,0,26,0,-26
21443,1,1,231,1232,1001
21444,1,1,651,1328,677
21445,1,1,296,1377,1081
21446,1,0,15,0,-15
21447,1,1,293,1448,1155
21448,0,0,4,0,-4
21449,1,0,91,0,-91
21450,1,1,822,1264,442
21451,0,0,38,0,-38
21452,1,1,324,1279,955
21453,1,1,765,1345,580
21454,0,0,99,0,-99
21455,1,1,24,1860,1836
21456,0,0,10,0,-10
21457,0,0,59,0,-59
21458,1,0,76,0,-76
21459,0,0,16,0,-16
21460,1,1,123,1882,1759
21461,0,0,8,0,-8
21462,0,0,132,0,-132
21463,0,0,23,0,-23
21464,0,0,58,0,-58
21465,1,1,229,1299,1070
21466,1,1,557,1798,1241
21467,1,0,11,0,-11
21468,1,1,1095,1377,282
21469,0,0,51,0,-51
21470,1,1,992,1231,239
21471,1,0,22,0,-22
21472,1,1,266,1225,959
21473,1,1,368,1219,851
21474,1,0,30,0,-30
21475,1,0,67,0,-67
21476,1,0,3,0,-3
21477,0,0,13,0,-13
21478,0,0,22,0,-22
21479,1,1,96,2049,1953
21480,0,0,70,0,-70
21481,1,1,395,1251,856
21482,1,0,26,0,-26
21483,0,0,21,0,-21
21484,0,0,83,0,-83
21485,0,0,67,0,-67
21486,0,0,11,0,-11
21487,1,1,32,1898,1866
21488,0,0,71,0,-71
21489,1,0,140,0,-140
21490,0,0,20,0,-20
21491,1,1,59,1288,1229
21492,1,0,24,0,-24
21493,1,1,459,1380,921
21494,1,1,70,1584,1514
21495,0,0,5,0,-5
21496,0,0,5,0,-5
21497,0,0,55,0,-55
21498,1,0,117,0,-117
21499,1,1,449,1243,794
21500,0,0,0,0,0
21501,1,1,399,1382,983
21502,1,0,141,0,-141
21503,1,0,31,0,-31
21504,1,0,136,0,-136
21505,1,0,13,0,-13
21506,0,0,15,0,-15
21507,0,0,66,0,-66
21508,0,0,0,0,0
21509,1,0,29,0,-29
21510,0,0,30,0,-30
21511,0,0,4,0,-4
21512,0,0,139,0,-139
21513,1,0,101,0,-101
21514,0,0,32,0,-32
21515,0,0,59,0,-59
21516,1,0,45,0,-45
21517,1,0,41,0,-41
21518,1,1,228,2090,1862
21519,0,0,16,0,-16
21520,0,0,51,0,-51
21521,1,0,1,0,-1
21522,0,0,127,0,-127
21523,0,0,45,0,-45
21524,0,0,43,0,-43
21525,0,0,171,0,-171
21526,0,0,158,0,-158
21527,1,0,53,0,-53
21528,0,0,51,0,-51
21529,1,1,127,1281,1154
21530,1,0,85,0,-85
21531,1,0,17,0,-17
21532,1,1,90,1312,1222
21533,0,0,8,0,-8
21534,0,0,30,0,-30
21535,1,1,1133,1321,188
21536,0,0,55,0,-55
21537,1,1,239,1412,1173
21538,1,1,409,1238,829
21539,0,0,67,0,-67
21540,1,0,31,0,-31
21541,1,1,156,1248,1092
21542,0,0,26,0,-26
21543,1,0,158,0,-158
21544,1,1,37,1294,1257
21545,0,0,42,0,-42
21546,1,1,151,1222,1071
21547,1,1,289,1348,1059
21548,1,0,4,0,-4
21549,1,1,44,1200,1156
21550,1,1,84,1253,1169
21551,1,1,520,1254,734
21552,0,0,20,0,-20
21553,1,1,621,3763,3142
21554,1,1,545,1267,722
21555,1,0,64,0,-64
21556,1,0,26,0,-26
21557,1,1,247,1827,1580
21558,1,0,66,0,-66
21559,1,0,48,0,-48
21560,1,0,120,0,-120
21561,0,0,17,0,-17
21562,1,0,51,0,-51
21563,1,1,211,1666,1455
21564,1,1,540,1315,775
21565,1,0,175,0,-175
21566,0,0,26,0,-26
21567,1,1,44,1394,1350
21568,1,0,120,0,-120
21569,0,0,61,0,-61
21570,1,0,11,0,-11
21571,1,0,119,0,-119
21572,0,0,106,0,-106
21573,0,0,227,0,-227
21574,1,0,57,0,-57
21575,1,1,698,1414,716
21576,0,0,180,0,-180
21577,0,0,28,0,-28
21578,0,0,127,0,-127
21579,1,0,16,0,-16
21580,0,0,14,0,-14
21581,1,1,947,1854,907
21582,0,0,9,0,-9
21583,1,1,71,1293,1222
21584,1,0,17,0,-17
21585,0,0,37,0,-37
21586,1,1,504,1266,762
21587,1,0,11,0,-11
21588,0,0,38,0,-38
21589,1,1,355,2706,2351
21590,0,0,16,0,-16
21591,1,1,509,1652,1143
21592,1,0,6,0,-6
21593,0,0,206,0,-206
21594,0,0,68,0,-68
21595,1,1,354,1295,941
21596,0,0,0,0,0
21597,1,1,441,1207,766
21598,1,0,107,0,-107
21599,1,0,70,0,-70
21600,0,0,11,0,-11
21601,0,0,144,0,-144
21602,1,0,4,0,-4
21603,1,0,46,0,-46
21604,0,0,62,0,-62
21605,0,0,29,0,-29
21606,0,0,49,0,-49
21607,0,0,62,0,-62
21608,0,0,144,0,-144
21609,1,1,205,1280,1075
21610,1,1,250,1345,1095
21611,0,0,63,0,-63
21612,0,0,0,0,0
21613,1,0,8,0,-8
21614,1,1,541,1739,1198
21615,1,1,237,1511,1274
21616,0,0,19,0,-19
21617,0,0,33,0,-33
21618,1,0,60,0,-60
21619,1,1,864,1506,642
21620,0,0,69,0,-69
21621,0,0,136,0,-136
21622,1,0,29,0,-29
21623,0,0,12,0,-12
21624,1,1,163,2537,2374
21625,0,0,4,0,-4
21626,0,0,53,0,-53
21627,0,0,130,0,-130
21628,1,0,13,0,-13
21629,1,0,56,0,-56
21630,0,0,67,0,-67
21631,1,0,70,0,-70
21632,0,0,104,0,-104
21633,0,0,26,0,-26
21634,1,0,57,0,-57
21635,1,1,1152,1307,155
21636,0,0,20,0,-20
21637,0,0,12,0,-12
21638,0,0,0,0,0
21639,1,1,291,2358,2067
21640,1,1,559,1319,760
21641,0,0,59,0,-59
21642,0,0,34,0,-34
21643,0,0,15,0,-15
21644,1,0,27,0,-27
21645,1,1,925,1444,519
21646,0,0,30,0,-30
21647,1,0,12,0,-12
21648,0,0,16,0,-16
21649,0,0,26,0,-26
21650,1,0,136,0,-136
21651,1,1,167,1302,1135
21652,0,0,10,0,-10
21653,1,0,17,0,-17
21654,1,1,259,1369,1110
21655,1,1,423,1502,1079
21656,1,1,129,1267,1138
21657,1,0,5,0,-5
21658,1,1,526,1378,852
21659,0,0,41,0,-41
21660,0,0,57,0,-57
21661,0,0,11,0,-11
21662,1,0,130,0,-130
21663,0,0,69,0,-69
21664,1,0,203,0,-203
21665,1,0,72,0,-72
21666,1,0,15,0,-15
21667,0,0,135,0,-135
21668,0,0,41,0,-41
21669,0,0,129,0,-129
21670,0,0,134,0,-134
21671,1,1,332,2036,1704
21672,1,0,50,0,-50
21673,1,1,483,2052,1569
21674,0,0,46,0,-46
21675,0,0,11,0,-11
21676,0,0,9,0,-9
21677,1,1,162,1274,1112
21678,0,0,14,0,-14
21679,0,0,60,0,-60
21680,1,0,48,0,-48
21681,1,0,27,0,-27
21682,0,0,27,0,-27
21683,1,1,167,1208,1041
21684,1,1,679,1696,1017
21685,0,0,0,0,0
21686,1,1,1093,2163,1070
21687,0,0,0,0,0
21688,1,0,209,0,-209
21689,1,0,7,0,-7
21690,1,0,68,0,-68
21691,1,0,39,0,-39
21692,0,0,101,0,-101
21693,0,0,7,0,-7
21694,1,1,322,2499,2177
21695,1,0,0,0,0
21696,0,0,43,0,-43
21697,0,0,9,0,-9
21698,1,0,48,0,-48
21699,1,1,610,1346,736
21700,1,1,551,1949,1398
21701,1,1,196,1444,1248
21702,1,1,995,2051,1056
21703,0,0,63,0,-63
21704,1,0,26,0,-26
21705,1,0,81,0,-81
21706,0,0,20,0,-20
21707,0,0,80,0,-80
21708,1,0,9,0,-9
21709,1,0,0,0,0
21710,1,1,905,1220,315
21711,1,0,80,0,-80
21712,1,1,130,1334,1204
21713,1,1,490,2292,1802
21714,1,1,1928,1544,-384
21715,0,0,103,0,-103
21716,1,0,37,0,-37
21717,1,1,163,2003,1840
21718,1,0,61,0,-61
21719,0,0,25,0,-25
21720,0,0,54,0,-54
21721,1,1,1071,1247,176
21722,0,0,90,0,-90
21723,1,0,5,0,-5
21724,1,1,80,1393,1313
21725,1,1,249,1400,1151
21726,1,1,425,1221,796
21727,1,1,115,1251,1136
21728,1,1,560,1272,712
21729,1,0,136,0,-136
21730,0,0,28,0,-28
21731,1,0,58,0,-58
21732,1,1,56,1470,1414
21733,1,1,294,1322,1028
21734,1,1,761,1392,631
21735,1,1,510,1297,787
21736,0,0,13,0,-13
21737,1,1,764,1266,502
21738,0,0,8,0,-8
21739,1,0,33,0,-33
21740,1,1,84,1324,1240
21741,1,1,716,1779,1063
21742,1,0,45,0,-45
21743,0,0,203,0,-203
21744,1,1,446,2229,1783
21745,1,1,278,1429,1151
21746,1,0,15,0,-15
21747,1,0,79,0,-79
21748,0,0,30,0,-30
21749,1,0,71,0,-71
21750,1,0,3,0,-3
21751,1,0,28,0,-28
21752,0,0,55,0,-55
21753,1,0,16,0,-16
21754,0,0,28,0,-28
21755,0,0,34,0,-34
21756,1,0,17,0,-17
21757,1,1,88,1216,1128
21758,0,0,80,0,-80
21759,0,0,46,0,-46
21760,0,0,16,0,-16
21761,1,0,14,0,-14
21762,1,1,452,1202,750
21763,1,0,98,0,-98
21764,1,0,39,0,-39
21765,1,0,47,0,-47
21766,1,1,166,1882,1716
21767,1,1,1084,1312,228
21768,0,0,54,0,-54
21769,1,0,10,0,-10
21770,1,0,2,0,-2
21771,1,0,5,0,-5
21772,1,1,180,2025,1845
21773,0,0,70,0,-70
21774,1,0,4,0,-4
21775,1,0,35,0,-35
21776,1,1,1896,1374,-522
21777,1,1,140,1386,1246
21778,1,1,563,1283,720
21779,1,1,1158,1392,234
21780,1,1,135,2053,1918
21781,1,0,144,0,-144
21782,1,0,1,0,-1
21783,1,0,43,0,-43
21784,1,1,638,1493,855
21785,1,1,92,1591,1499
21786,1,0,59,0,-59
21787,1,0,112,0,-112
21788,1,0,14,0,-14
21789,1,0,32,0,-32
21790,0,0,34,0,-34
21791,0,0,30,0,-30
21792,0,0,12,0,-12
21793,1,1,137,2885,2748
21794,0,0,6,0,-6
21795,1,0,27,0,-27
21796,1,1,305,1324,1019
21797,0,0,46,0,-46
21798,0,0,9,0,-9
21799,1,1,606,1579,973
21800,0,0,37,0,-37
21801,1,1,12,1301,1289
21802,0,0,31,0,-31
21803,1,1,1415,1248,-167
21804,1,1,784,1325,541
21805,1,1,241,1839,1598
21806,0,0,28,0,-28
21807,1,1,1426,1551,125
21808,0,0,109,0,-109
21809,1,0,11,0,-11
21810,0,0,14,0,-14
21811,0,0,68,0,-68
21812,1,1,93,3488,3395
21813,1,0,43,0,-43
21814,0,0,9,0,-9
21815,1,0,18,0,-18
21816,0,0,14,0,-14
21817,0,0,47,0,-47
21818,0,0,20,0,-20
21819,1,1,913,1310,397
21820,0,0,10,0,-10
21821,0,0,92,0,-92
21822,1,1,224,1480,1256
21823,0,0,59,0,-59
21824,0,0,36,0,-36
21825,0,0,57,0,-57
21826,1,1,404,1341,937
21827,1,0,73,0,-73
21828,1,1,461,1583,1122
21829,0,0,2,0,-2
21830,1,1,438,2033,1595
21831,0,0,43,0,-43
21832,1,1,243,2318,2075
21833,1,0,131,0,-131
21834,0,0,180,0,-180
21835,0,0,145,0,-145
21836,0,0,70,0,-70
21837,0,0,0,0,0
21838,0,0,12,0,-12
21839,0,0,2,0,-2
21840,0,0,80,0,-80
21841,1,0,94,0,-94
21842,0,0,154,0,-154
21843,1,0,53,0,-53
21844,1,1,1346,1243,-103
21845,1,0,6,0,-6
21846,1,1,1726,2762,1036
21847,1,0,50,0,-50
21848,1,1,337,1402,1065
21849,1,0,35,0,-35
21850,1,1,190,1271,1081
21851,0,0,73,0,-73
21852,0,0,130,0,-130
21853,0,0,35,0,-35
21854,1,1,514,1280,766
21855,0,0,79,0,-79
21856,0,0,67,0,-67
21857,1,1,428,1530,1102
21858,1,0,38,0,-38
21859,0,0,18,0,-18
21860,1,1,530,1740,1210
21861,0,0,47,0,-47
21862,1,1,205,2038,1833
21863,0,0,21,0,-21
21864,1,0,44,0,-44
21865,0,0,95,0,-95
21866,0,0,66,0,-66
21867,0,0,23,0,-23
21868,1,0,11,0,-11
21869,1,1,429,1365,936
21870,1,0,154,0,-154
21871,0,0,42,0,-42
21872,1,1,574,1403,829
21873,1,0,0,0,0
21874,1,1,378,1241,863
21875,1,0,86,0,-86
21876,0,0,84,0,-84
21877,1,1,47,2468,2421
21878,1,0,96,0,-96
21879,1,1,381,1448,1067
21880,1,1,682,1332,650
21881,1,0,20,0,-20
21882,1,1,124,1423,1299
21883,0,0,4,0,-4
21884,1,1,365,2066,1701
21885,1,0,50,0,-50
21886,0,0,22,0,-22
21887,1,0,17,0,-17
21888,0,0,47,0,-47
21889,1,0,34,0,-34
21890,0,0,45,0,-45
21891,0,0,6,0,-6
21892,1,1,451,2582,2131
21893,0,0,102,0,-102
21894,0,0,40,0,-40
21895,0,0,4,0,-4
21896,1,0,50,0,-50
21897,0,0,9,0,-9
21898,1,0,80,0,-80
21899,0,0,1,0,-1
21900,1,1,575,2194,1619
21901,1,1,175,1976,1801
21902,1,0,23,0,-23
21903,0,0,7,0,-7
21904,1,0,20,0,-20
21905,1,0,21,0,-21
21906,0,0,63,0,-63
21907,1,0,85,0,-85
21908,1,1,274,1245,971
21909,0,0,95,0,-95
21910,0,0,17,0,-17
21911,1,0,70,0,-70
21912,1,1,2045,1782,-263
21913,0,0,115,0,-115
21914,1,0,4,0,-4
21915,1,0,3,0,-3
21916,1,0,104,0,-104
21917,1,0,68,0,-68
21918,1,0,197,0,-197
21919,0,0,2,0,-2
21920,0,0,11,0,-11
21921,1,1,680,1208,528
21922,0,0,26,0,-26
21923,1,0,24,0,-24
21924,0,0,15,0,-15
21925,0,0,149,0,-149
21926,1,1,1799,1560,-239
21927,0,0,20,0,-20
21928,1,0,38,0,-38
21929,0,0,76,0,-76
21930,0,0,21,0,-21
21931,1,1,131,1494,1363
21932,1,0,62,0,-62
21933,1,0,32,0,-32
21934,1,0,64,0,-64
21935,1,1,1366,1571,205
21936,0,0,95,0,-95
21937,0,0,54,0,-54
21938,0,0,78,0,-78
21939,0,0,105,0,-105
21940,1,1,104,1793,1689
21941,0,0,10,0,-10
21942,1,1,124,2673,2549
21943,1,0,41,0,-41
21944,1,0,41,0,-41
21945,1,0,9,0,-9
21946,1,1,854,2191,1337
21947,1,1,798,1325,527
21948,0,0,4,0,-4
21949,1,1,1130,1465,335
21950,1,0,107,0,-107
21951,1,1,104,1253,1149
21952,1,1,739,1279,540
21953,0,0,48,0,-48
21954,0,0,290,0,-290
21955,1,1,810,1335,525
21956,1,0,18,0,-18
21957,1,1,804,2045,1241
21958,1,0,68,0,-68
21959,1,1,1333,1579,246
21960,0,0,87,0,-87
21961,1,1,515,1206,691
21962,1,0,3,0,-3
21963,0,0,40,0,-40
21964,1,0,25,0,-25
21965,0,0,69,0,-69
21966,1,0,9,0,-9
21967,1,1,188,1319,1131
21968,1,1,378,1309,931
21969,1,0,46,0,-46
21970,0,0,44,0,-44
21971,1,0,98,0,-98
21972,1,0,7,0,-7
21973,0,0,4,0,-4
21974,0,0,91,0,-91
21975,1,0,91,0,-91
21976,1,1,295,2088,1793
21977,1,0,23,0,-23
21978,1,0,4,0,-4
21979,1,1,73,1581,1508
21980,1,0,11,0,-11
21981,0,0,73,0,-73
21982,1,1,15,1223,1208
21983,0,0,41,0,-41
21984,1,1,321,1570,1249
21985,1,1,810,1568,758
21986,1,0,4,0,-4
21987,0,0,53,0,-53
21988,1,0,33,0,-33
21989,1,0,67,0,-67
21990,1,0,13,0,-13
21991,0,0,11,0,-11
21992,0,0,14,0,-14
21993,1,0,154,0,-154
21994,0,0,17,0,-17
21995,1,1,461,1383,922
21996,1,0,50,0,-50
21997,0,0,74,0,-74
21998,0,0,16,0,-16
21999,0,0,15,0,-15
22000,1,1,599,1936,1337
22001,1,1,366,1580,1214
22002,0,0,15,0,-15
22003,1,0,36,0,-36
22004,1,0,23,0,-23
22005,1,1,303,1338,1035
22006,1,1,216,1741,1525
22007,1,0,71,0,-71
22008,0,0,26,0,-26
22009,0,0,7,0,-7
22010,0,0,90,0,-90
22011,1,0,25,0,-25
22012,0,0,2,0,-2
22013,1,0,40,0,-40
22014,1,1,336,1300,964
22015,1,1,865,1215,350
22016,1,1,239,1341,1102
22017,0,0,12,0,-12
22018,1,1,943,1941,998
22019,1,0,44,0,-44
22020,1,1,1857,1678,-179
22021,1,1,249,1237,988
22022,1,0,61,0,-61
22023,1,1,954,3397,2443
22024,1,1,247,1599,1352
22025,0,0,16,0,-16
22026,1,0,21,0,-21
22027,1,1,113,1280,1167
22028,0,0,33,0,-33
22029,1,1,454,2859,2405
22030,1,0,67,0,-67
22031,0,0,118,0,-118
22032,1,0,15,0,-15
22033,1,1,848,1305,457
22034,1,0,65,0,-65
22035,0,0,344,0,-344
22036,0,0,13,0,-13
22037,1,0,102,0,-102
22038,1,1,402,1454,1052
22039,1,0,26,0,-26
22040,0,0,18,0,-18
22041,1,0,135,0,-135
22042,1,0,11,0,-11
22043,1,1,46,1233,1187
22044,1,1,81,1300,1219
22045,1,0,38,0,-38
22046,0,0,115,0,-115
22047,1,0,20,0,-20
22048,1,1,964,1236,272
22049,1,0,128,0,-128
22050,1,1,992,1432,440
22051,1,0,12,0,-12
22052,0,0,49,0,-49
22053,1,0,12,0,-12
22054,0,0,121,0,-121
22055,0,0,22,0,-22
22056,0,0,37,0,-37
22057,1,1,153,1307,1154
22058,0,0,16,0,-16
22059,0,0,10,0,-10
22060,1,0,45,0,-45
22061,0,0,51,0,-51
22062,1,1,81,1642,1561
22063,1,0,3,0,-3
22064,1,1,109,1351,1242
22065,1,1,816,1444,628
22066,1,0,24,0,-24
22067,0,0,10,0,-10
22068,1,0,95,0,-95
22069,1,1,409,1279,870
22070,0,0,8,0,-8
22071,1,0,8,0,-8
22072,0,0,36,0,-36
22073,1,1,64,1222,1158
22074,0,0,3,0,-3
22075,1,1,441,1231,790
22076,1,0,126,0,-126
22077,1,0,24,0,-24
22078,1,0,29,0,-29
22079,1,0,91,0,-91
22080,1,0,68,0,-68
22081,0,0,20,0,-20
22082,1,0,54,0,-54
22083,1,1,1135,1302,167
22084,1,0,103,0,-103
22085,0,0,19,0,-19
22086,1,1,71,1840,1769
22087,1,1,583,1200,617
22088,1,0,28,0,-28
22089,1,0,23,0,-23
22090,0,0,22,0,-22
22091,1,0,9,0,-9
22092,0,0,38,0,-38
22093,0,0,40,0,-40
22094,0,0,82,0,-82
22095,1,1,474,1651,1177
22096,0,0,64,0,-64
22097,1,0,53,0,-53
22098,1,1,232,2422,2190
22099,1,0,13,0,-13
22100,1,0,0,0,0
22101,1,0,41,0,-41
22102,0,0,0,0,0
22103,1,1,626,1582,956
22104,1,1,486,1817,1331
22105,1,1,861,1276,415
22106,1,1,155,1307,1152
22107,1,1,259,1677,1418
22108,1,0,104,0,-104
22109,1,1,18,2227,2209
22110,1,0,8,0,-8
22111,1,1,1273,1354,81
22112,1,0,12,0,-12
22113,1,1,673,1244,571
22114,0,0,2,0,-2
22115,0,0,37,0,-37
22116,1,0,62,0,-62
22117,0,0,12,0,-12
22118,1,1,668,1556,888
22119,0,0,22,0,-22
22120,1,0,57,0,-57
22121,1,0,167,0,-167
22122,1,0,2,0,-2
22123,0,0,47,0,-47
22124,0,0,25,0,-25
22125,0,0,40,0,-40
22126,1,0,74,0,-74
22127,1,0,19,0,-19
22128,0,0,80,0,-80
22129,0,0,36,0,-36
22130,1,1,1416,2151,735
22131,0,0,33,0,-33
22132,0,0,122,0,-122
22133,1,1,451,2181,1730
22134,1,1,575,1501,926
22135,1,1,1258,1321,63
22136,0,0,52,0,-52
22137,0,0,39,0,-39
22138,0,0,110,0,-110
22139,1,0,85,0,-85
22140,0,0,4,0,-4
22141,0,0,12,0,-12
22142,1,0,18,0,-18
22143,1,0,67,0,-67
22144,0,0,6,0,-6
22145,0,0,11,0,-11
22146,1,0,92,0,-92
22147,1,1,979,1428,449
22148,0,0,100,0,-100
22149,0,0,18,0,-18
22150,0,0,83,0,-83
22151,0,0,199,0,-199
22152,0,0,169,0,-169
22153,0,0,171,0,-171
22154,1,0,42,0,-42
22155,1,1,105,1213,1108
22156,0,0,168,0,-168
22157,1,0,41,0,-41
22158,1,1,227,1345,1118
22159,0,0,54,0,-54
22160,1,0,217,0,-217
22161,0,0,4,0,-4
22162,1,1,1081,1788,707
22163,1,0,213,0,-213
22164,1,1,337,1703,1366
22165,1,1,231,2981,2750
22166,1,0,28,0,-28
22167,1,0,14,0,-14
22168,1,1,490,2662,2172
22169,1,1,638,1222,584
22170,1,0,46,0,-46
22171,0,0,31,0,-31
22172,0,0,11,0,-11
22173,1,0,20,0,-20
22174,1,0,36,0,-36
22175,1,1,296,1686,1390
22176,0,0,65,0,-65
22177,1,0,2,0,-2
22178,1,1,439,1332,893
22179,1,1,336,2124,1788
22180,1,1,158,1956,1798
22181,1,0,15,0,-15
22182,1,0,12,0,-12
22183,1,1,155,1387,1232
22184,1,1,154,1496,1342
22185,1,0,5,0,-5
22186,1,0,44,0,-44
22187,0,0,3,0,-3
22188,1,1,543,1274,731
22189,1,0,58,0,-58
22190,1,0,160,0,-160
22191,1,1,899,2395,1496
22192,1,1,600,1217,617
22193,1,1,735,1221,486
22194,1,1,212,1374,1162
22195,0,0,24,0,-24
22196,1,1,369,1785,1416
22197,0,0,43,0,-43
22198,1,0,170,0,-170
22199,1,0,5,0,-5
22200,0,0,31,0,-31
22201,0,0,128,0,-128
22202,1,1,294,1464,1170
22203,1,0,0,0,0
22204,0,0,78,0,-78
22205,0,0,23,0,-23
22206,1,0,71,0,-71
22207,0,0,55,0,-55
22208,0,0,13,0,-13
22209,0,0,6,0,-6
22210,0,0,4,0,-4
22211,1,0,47,0,-47
22212,1,1,570,1313,743
22213,1,0,4,0,-4
22214,1,1,333,2223,1890
22215,1,0,21,0,-21
22216,0,0,5,0,-5
22217,1,0,130,0,-130
22218,0,0,47,0,-47
22219,1,1,803,1674,871
22220,0,0,0,0,0
22221,0,0,23,0,-23
22222,0,0,35,0,-35
22223,1,1,605,1908,1303
22224,1,1,749,1533,784
22225,0,0,41,0,-41
22226,0,0,58,0,-58
22227,1,1,1637,1603,-34
22228,1,1,2894,1728,-1166
22229,1,1,246,1883,1637
22230,0,0,6,0,-6
22231,1,1,592,1373,781
22232,0,0,18,0,-18
22233,1,0,99,0,-99
22234,1,1,397,1464,1067
22235,1,0,63,0,-63
22236,0,0,82,0,-82
22237,0,0,18,0,-18
22238,0,0,23,0,-23
22239,1,0,46,0,-46
22240,0,0,36,0,-36
22241,1,0,58,0,-58
22242,1,0,1,0,-1
22243,0,0,43,0,-43
22244,0,0,74,0,-74
22245,1,1,579,1842,1263
22246,0,0,18,0,-18
22247,1,1,211,1385,1174
22248,1,1,328,1213,885
22249,1,0,20,0,-20
22250,1,1,273,1341,1068
22251,1,0,83,0,-83
22252,1,0,89,0,-89
22253,0,0,37,0,-37
22254,0,0,2,0,-2
22255,1,1,187,1390,1203
22256,1,0,57,0,-57
22257,1,1,139,2194,2055
22258,1,0,17,0,-17
22259,0,0,19,0,-19
22260,1,0,6,0,-6
22261,0,0,100,0,-100
22262,1,1,338,1316,978
22263,0,0,13,0,-13
22264,1,1,167,2041,1874
22265,0,0,18,0,-18
22266,0,0,12,0,-12
22267,0,0,112,0,-112
22268,0,0,29,0,-29
22269,1,1,399,1386,987
22270,0,0,215,0,-215
22271,0,0,36,0,-36
22272,0,0,59,0,-59
22273,0,0,93,0,-93
22274,0,0,18,0,-18
22275,1,0,4,0,-4
22276,1,1,405,1327,922
22277,0,0,13,0,-13
22278,1,0,78,0,-78
22279,1,1,1080,1243,163
22280,1,0,66,0,-66
22281,1,1,1426,1321,-105
22282,0,0,76,0,-76
22283,1,1,454,1734,1280
22284,0,0,50,0,-50
22285,1,1,67,1321,1254
22286,0,0,25,0,-25
22287,0,0,149,0,-149
22288,1,0,66,0,-66
22289,1,0,17,0,-17
22290,1,0,16,0,-16
22291,0,0,25,0,-25
22292,0,0,69,0,-69
22293,0,0,103,0,-103
22294,1,0,56,0,-56
22295,1,1,121,1718,1597
22296,0,0,1,0,-1
22297,0,0,6,0,-6
22298,1,1,439,1460,1021
22299,1,0,10,0,-10
22300,1,1,438,1675,1237
22301,1,0,42,0,-42
22302,1,1,33,1670,1637
22303,0,0,76,0,-76
22304,1,0,33,0,-33
22305,1,1,317,1958,1641
22306,1,0,8,0,-8
22307,0,0,54,0,-54
22308,1,0,125,0,-125
22309,0,0,2,0,-2
22310,1,1,203,1269,1066
22311,0,0,17,0,-17
22312,1,0,59,0,-59
22313,1,0,107,0,-107
22314,1,0,24,0,-24
22315,1,1,450,1511,1061
22316,1,0,34,0,-34
22317,1,0,62,0,-62
22318,0,0,69,0,-69
22319,1,1,275,1478,1203
22320,1,1,271,2510,2239
22321,0,0,9,0,-9
22322,0,0,116,0,-116
22323,1,0,49,0,-49
22324,0,0,50,0,-50
22325,0,0,19,0,-19
22326,1,0,4,0,-4
22327,0,0,38,0,-38
22328,0,0,48,0,-48
22329,1,0,113,0,-113
22330,0,0,88,0,-88
22331,1,1,552,1860,1308
22332,0,0,2,0,-2
22333,1,1,469,1284,815
22334,1,1,392,1989,1597
22335,1,1,327,1349,1022
22336,0,0,10,0,-10
22337,0,0,54,0,-54
22338,0,0,9,0,-9
22339,1,1,822,1299,477
22340,0,0,17,0,-17
22341,0,0,22,0,-22
22342,1,0,60,0,-60
22343,0,0,39,0,-39
22344,1,1,464,2939,2475
22345,0,0,101,0,-101
22346,1,0,35,0,-35
22347,1,1,199,1204,1005
22348,1,0,4,0,-4
22349,0,0,3,0,-3
22350,1,1,214,1335,1121
22351,1,0,7,0,-7
22352,1,0,54,0,-54
22353,1,0,45,0,-45
22354,1,1,649,1326,677
22355,0,0,56,0,-56
22356,1,0,26,0,-26
22357,0,0,13,0,-13
22358,1,1,253,1271,1018
22359,1,1,459,1387,928
22360,0,0,511,0,-511
22361,1,1,340,1294,954
22362,1,0,22,0,-22
22363,0,0,28,0,-28
22364,0,0,2,0,-2
22365,1,0,25,0,-25
22366,0,0,29,0,-29
22367,1,1,64,1652,1588
22368,0,0,2,0,-2
22369,0,0,270,0,-270
22370,0,0,59,0,-59
22371,0,0,8,0,-8
22372,1,0,34,0,-34
22373,0,0,111,0,-111
22374,1,0,98,0,-98
22375,0,0,7,0,-7
22376,0,0,44,0,-44
22377,1,1,102,1465,1363
22378,0,0,2,0,-2
22379,0,0,34,0,-34
22380,0,0,55,0,-55
22381,0,0,27,0,-27
22382,0,0,35,0,-35
22383,1,1,330,1284,954
22384,0,0,17,0,-17
22385,1,1,1272,1296,24
22386,0,0,51,0,-51
22387,0,0,37,0,-37
22388,1,1,627,1840,1213
22389,1,0,134,0,-134
22390,0,0,178,0,-178
22391,1,0,2,0,-2
22392,0,0,13,0,-13
22393,1,0,27,0,-27
22394,0,0,18,0,-18
22395,0,0,55,0,-55
22396,1,0,16,0,-16
22397,0,0,59,0,-59
22398,1,1,796,2603,1807
22399,0,0,14,0,-14
22400,0,0,12,0,-12
22401,1,0,104,0,-104
22402,1,0,85,0,-85
22403,1,1,84,1293,1209
22404,1,0,6,0,-6
22405,1,1,139,1535,1396
22406,1,0,153,0,-153
22407,0,0,128,0,-128
22408,1,0,67,0,-67
22409,0,0,18,0,-18
22410,0,0,47,0,-47
22411,1,1,854,1444,590
22412,1,0,15,0,-15
22413,1,1,355,1359,1004
22414,0,0,109,0,-109
22415,1,1,20,1336,1316
22416,1,0,66,0,-66
22417,1,1,239,1909,1670
22418,1,1,93,2344,2251
22419,0,0,8,0,-8
22420,1,1,81,1235,1154
22421,1,0,9,0,-9
22422,1,1,1008,1279,271
22423,0,0,16,0,-16
22424,0,0,148,0,-148
22425,1,0,33,0,-33
22426,0,0,0,0,0
22427,1,0,90,0,-90
22428,0,0,30,0,-30
22429,1,1,569,2142,1573
22430,0,0,1,0,-1
22431,0,0,96,0,-96
22432,1,0,23,0,-23
22433,0,0,40,0,-40
22434,1,1,134,1345,1211
22435,0,0,97,0,-97
22436,0,0,6,0,-6
22437,1,0,73,0,-73
22438,0,0,42,0,-42
22439,0,0,56,0,-56
22440,1,0,49,0,-49
22441,1,1,746,1666,920
22442,1,0,94,0,-94
22443,0,0,54,0,-54
22444,0,0,20,0,-20
22445,0,0,54,0,-54
22446,1,1,764,1514,750
22447,1,1,851,1217,366
22448,0,0,34,0,-34
22449,1,0,46,0,-46
22450,1,1,133,2338,2205
22451,0,0,52,0,-52
22452,1,1,584,1692,1108
22453,1,0,8,0,-8
22454,0,0,218,0,-218
22455,0,0,29,0,-29
22456,1,1,387,1279,892
22457,1,0,41,0,-41
22458,1,0,169,0,-169
22459,1,0,247,0,-247
22460,1,1,600,1354,754
22461,1,0,20,0,-20
22462,1,0,44,0,-44
22463,0,0,12,0,-12
22464,1,1,282,1659,1377
22465,1,1,1342,1451,109
22466,0,0,40,0,-40
22467,1,0,18,0,-18
22468,0,0,6,0,-6
22469,1,1,66,1312,1246
22470,1,0,5,0,-5
22471,1,0,32,0,-32
22472,0,0,105,0,-105
22473,1,0,86,0,-86
22474,0,0,7,0,-7
22475,1,1,336,1345,1009
22476,0,0,86,0,-86
22477,1,0,21,0,-21
22478,1,0,26,0,-26
22479,1,0,1,0,-1
22480,0,0,102,0,-102
22481,0,0,21,0,-21
22482,1,0,34,0,-34
22483,0,0,137,0,-137
22484,1,1,271,1502,1231
22485,0,0,103,0,-103
22486,1,1,517,2219,1702
22487,0,0,29,0,-29
22488,1,1,495,1219,724
22489,1,1,47,1325,1278
22490,0,0,9,0,-9
22491,1,0,83,0,-83
22492,0,0,87,0,-87
22493,1,0,66,0,-66
22494,0,0,123,0,-123
22495,0,0,114,0,-114
22496,1,1,1990,1616,-374
22497,1,1,523,1618,1095
22498,0,0,15,0,-15
22499,1,0,20,0,-20
22500,1,1,712,1391,679
22501,1,0,35,0,-35
22502,1,1,78,1270,1192
22503,1,0,52,0,-52
22504,1,0,2,0,-2
22505,1,1,364,1624,1260
22506,1,1,449,1316,867
22507,1,1,123,1456,1333
22508,1,0,32,0,-32
22509,1,0,85,0,-85
22510,0,0,77,0,-77
22511,1,0,22,0,-22
22512,1,0,0,0,0
22513,1,0,111,0,-111
22514,0,0,68,0,-68
22515,1,0,85,0,-85
22516,1,1,92,2980,2888
22517,1,1,141,1251,1110
22518,1,0,51,0,-51
22519,0,0,24,0,-24
22520,0,0,30,0,-30
22521,0,0,66,0,-66
22522,0,0,74,0,-74
22523,1,0,107,0,-107
22524,0,0,68,0,-68
22525,0,0,1,0,-1
22526,0,0,41,0,-41
22527,0,0,135,0,-135
22528,0,0,39,0,-39
22529,0,0,126,0,-126
22530,1,0,10,0,-10
